32 20
105 105 105 105 105 105 105 105 105 105 105 105 48 49 50 51 48 49 50 51 48 49 50 51 48 49 50 51 48 49 50 51 
105 105 105 105 105 105 105 105 105 105 105 105 52 53 54 55 52 53 54 55 52 53 54 55 52 53 54 55 52 53 54 55 
105 105 105 105 105 105 105 105 105 105 105 105 56 57 58 59 56 57 58 59 56 57 58 59 56 57 58 59 56 57 58 59 
105 105 105 105 105 105 105 105 105 105 105 105 44 45 46 47 105 105 105 105 105 105 105 105 105 105 105 105 105 105 105 105 
105 105 105 105 105 105 105 105 105 105 105 105 48 49 50 51 60 70 71 63 60 61 62 63 60 70 71 63 60 61 62 63 
105 105 105 105 105 105 105 105 105 105 105 105 52 53 54 55 52 72 73 55 52 53 54 55 52 72 73 55 52 53 54 55 
105 105 105 105 105 105 105 105 105 105 105 105 56 57 58 59 56 74 75 59 56 57 58 59 56 74 75 59 56 57 58 59 
105 105 105 105 105 105 105 105 105 105 105 105 105 105 105 105 105 105 105 105 105 105 105 105 105 105 105 105 105 105 105 105 
60 70 71 63 60 61 62 63 60 61 62 63 60 61 62 63 60 61 62 63 60 61 105 105 60 61 62 63 60 70 71 63 
52 72 73 55 52 53 54 55 52 53 54 55 52 53 54 55 52 53 54 55 52 53 105 105 52 53 54 55 52 72 73 55 
56 74 75 59 56 57 58 59 56 57 58 59 56 57 58 59 56 57 58 59 56 57 105 105 56 57 58 59 56 74 75 59 
105 105 105 105 105 105 105 105 105 105 105 105 44 45 46 47 105 105 105 105 44 45 105 105 44 45 105 105 105 105 105 105 
105 105 105 105 60 61 62 63 60 61 105 105 48 49 50 51 60 70 71 63 48 49 105 105 48 49 62 63 105 105 105 105 
105 105 105 105 52 53 54 55 52 53 105 105 52 53 54 55 52 72 73 55 52 53 105 105 52 53 54 55 105 105 105 105 
105 105 105 105 56 57 58 59 56 57 105 105 56 57 58 59 56 74 75 59 56 57 105 105 56 57 58 59 105 105 105 105 
105 105 105 105 44 45 46 47 105 105 105 105 44 45 46 47 105 105 105 105 105 105 105 105 105 105 46 47 105 105 105 105 
105 105 105 105 48 49 50 51 60 70 71 63 48 49 50 51 60 61 62 63 60 70 71 63 60 61 50 51 105 105 105 105 
105 105 105 105 52 53 54 55 52 72 73 55 52 53 54 55 52 53 54 55 52 72 73 55 52 53 54 55 105 105 105 105 
105 105 105 105 56 57 58 59 56 74 75 59 56 57 58 59 56 57 58 59 56 74 75 59 56 57 58 59 105 105 105 105 
105 105 105 105 105 105 105 105 105 105 105 105 105 105 105 105 105 105 105 105 105 105 105 105 105 105 105 105 105 105 105 105 

8 
STONE 128 208 -1
STONE 304 208 0
STONE 304 80 0
ENEMY SMOKE 64 144 0
ENEMY SMOKE 160 272 0
ENEMY SMOKE 352 256 1
ENEMY SMOKE 288 16 0
ENEMY SMOKE 416 80 0
