32 20
105 105 50 51 48 49 50 51 48 49 50 51 48 49 50 51 48 49 50 51 48 49 50 51 48 49 50 51 48 49 105 105 
105 105 54 55 52 53 54 55 52 53 54 55 52 53 54 55 52 53 54 55 52 53 54 55 52 53 54 55 52 53 105 105 
105 105 58 59 56 57 58 59 56 57 58 59 56 57 58 59 56 57 58 59 56 57 58 59 56 57 58 59 56 57 105 105 
105 105 105 105 105 105 105 105 105 105 105 105 105 105 105 105 105 105 106 106 105 105 105 105 106 106 105 105 105 105 105 105 
105 105 62 63 60 61 62 63 60 70 71 63 60 61 62 63 60 61 62 63 60 61 62 63 60 61 62 63 60 61 105 105 
105 105 54 55 52 53 54 55 52 72 73 55 52 53 54 55 52 53 54 55 52 53 54 55 52 53 54 55 52 53 105 105 
105 105 58 59 56 57 58 59 56 74 75 59 56 57 58 59 56 57 58 59 56 57 58 59 56 57 58 59 56 57 105 105 
105 105 105 105 105 105 105 105 105 105 105 105 44 45 46 47 44 45 46 47 44 45 46 47 44 45 46 47 44 45 105 105 
105 105 50 51 60 61 62 63 60 61 62 63 48 49 50 51 48 49 50 51 48 49 50 51 48 49 50 51 48 49 62 63 
105 105 54 55 52 53 54 55 52 53 54 55 52 53 54 55 52 53 54 55 52 53 54 55 52 53 54 55 52 53 54 55 
105 105 58 59 56 57 58 59 56 57 58 59 56 57 58 59 56 57 58 59 56 57 58 59 56 57 58 59 56 57 58 59 
105 105 46 47 44 45 106 106 105 105 105 105 105 105 105 105 105 105 105 105 105 105 105 105 105 105 105 105 105 105 105 105 
105 105 50 51 48 49 62 63 60 61 62 63 60 61 62 63 60 70 71 63 60 61 62 63 60 70 71 63 60 61 62 63 
105 105 54 55 52 53 54 55 52 53 54 55 52 53 54 55 52 72 73 55 52 53 54 55 52 72 73 55 52 53 54 55 
105 105 58 59 56 57 58 59 56 57 58 59 56 57 58 59 56 74 75 59 56 57 58 59 56 74 75 59 56 57 58 59 
105 105 46 47 44 45 46 47 44 45 46 47 105 105 106 106 105 105 105 105 105 105 105 105 105 105 105 105 105 105 105 105 
105 105 50 51 48 49 50 51 48 49 50 51 105 105 62 63 105 105 105 105 60 70 71 63 60 61 62 63 60 70 71 63 
105 105 54 55 52 53 54 55 52 53 54 55 105 105 54 55 105 105 105 105 52 72 73 55 52 53 54 55 52 72 73 55 
105 105 58 59 56 57 58 59 56 57 58 59 105 105 58 59 105 105 105 105 56 74 75 59 56 57 58 59 56 74 75 59 
105 105 105 105 105 105 105 105 105 105 105 105 105 105 46 47 105 105 105 105 105 105 105 105 105 105 105 105 105 105 105 105 

16 
LADDER 96 192 7 0
LADDER 224 256 5 0
LADDER 288 64 7 0
LADDER 384 64 7 0
LADDER 224 0 3 0
STONE 256 16 -3
STONE 128 144 0
STONE 368 272 0
ENEMY BAT 352 256
ENEMY BAT 352 192
ENEMY BAT 160 128
ENEMY BAT 64 64
ENEMY SMOKE 192 144 0
ENEMY SMOKE 384 16 0
ENEMY SMOKE 416 256 1
ENEMY SMOKE 320 16 0

APPEARWALL 20 12