32 20
105 105 50 51 48 49 50 51 48 49 50 51 48 49 50 51 48 49 50 51 48 49 50 51 48 49 50 51 48 49 50 51 
105 105 54 55 52 53 54 55 52 53 54 55 52 53 54 55 52 53 54 55 52 53 54 55 52 53 54 55 52 53 54 55 
105 105 58 59 56 57 58 59 56 57 58 59 56 57 58 59 56 57 58 59 56 57 58 59 56 57 58 59 56 57 58 59 
105 105 46 47 44 45 46 47 44 45 46 47 44 45 46 47 44 45 46 47 44 45 46 47 44 45 46 47 105 105 105 105 
105 105 50 51 48 49 50 51 48 49 50 51 48 49 50 51 48 49 50 51 48 49 50 51 48 49 50 51 60 70 71 63 
105 105 54 55 52 53 54 55 52 53 54 55 52 53 54 55 52 53 54 55 52 53 54 55 52 53 54 55 52 72 73 55 
105 105 58 59 56 57 58 59 56 57 58 59 56 57 58 59 56 57 58 59 56 57 58 59 56 57 58 59 56 74 75 59 
105 105 46 47 44 45 105 105 105 105 46 47 44 45 46 47 44 45 46 47 44 45 105 105 105 105 105 105 105 105 105 105 
105 105 50 51 48 49 62 63 60 61 50 51 48 49 50 51 48 49 50 51 48 49 105 105 105 105 105 105 105 105 105 105 
105 105 54 55 52 53 54 55 52 53 54 55 52 53 54 55 52 53 54 55 52 53 105 105 105 105 105 105 105 105 105 105 
105 105 58 59 56 57 58 59 56 57 58 59 56 57 58 59 56 57 58 59 56 57 105 105 105 105 105 105 105 105 105 105 
105 105 46 47 44 45 46 47 44 45 46 47 44 45 46 47 44 45 46 47 44 45 105 105 105 105 105 105 105 105 105 105 
105 105 50 51 48 49 50 51 48 49 50 51 48 49 50 51 48 49 50 51 48 49 105 105 105 105 105 105 105 105 105 105 
105 105 54 55 52 53 54 55 52 53 54 55 52 53 54 55 52 53 54 55 52 53 105 105 105 105 105 105 105 105 105 105 
105 105 58 59 56 57 58 59 56 57 58 59 56 57 58 59 56 57 58 59 56 57 105 105 105 105 105 105 105 105 105 105 
105 105 46 47 44 45 46 47 44 45 46 47 44 45 46 47 44 45 46 47 44 45 105 105 105 105 105 105 105 105 105 105 
60 61 50 51 48 49 50 51 48 49 50 51 48 49 50 51 48 49 50 51 48 49 105 105 105 105 105 105 105 105 105 105 
52 53 54 55 52 53 54 55 52 53 54 55 52 53 54 55 52 53 54 55 52 53 105 105 105 105 105 105 105 105 105 105 
56 57 58 59 56 57 58 59 56 57 58 59 56 57 58 59 56 57 58 59 56 57 105 105 105 105 105 105 105 105 105 105 
105 105 105 105 105 105 46 47 44 45 46 47 44 45 46 47 44 45 46 47 44 45 105 105 105 105 105 105 105 105 105 105 

5 
ENEMY SMOKE 96 80 0
ENEMY SMOKE 64 272 0
ENEMY BAT 96 128
ENEMY BAT 128 128
ENEMY SMOKE 384 80 0
