32 20
105 105 0 1 0 1 0 1 0 1 0 1 0 1 0 1 0 1 0 1 0 1 0 1 0 1 0 1 0 1 105 105 
105 105 1 0 1 0 1 0 1 0 1 0 1 0 1 0 1 0 1 0 1 0 1 0 1 0 1 0 1 0 105 105 
105 105 0 1 0 1 0 1 0 1 0 1 0 1 0 1 0 1 0 1 0 1 0 1 0 1 0 1 0 1 105 105 
105 105 105 105 105 105 105 105 105 105 105 105 105 105 1 0 1 0 105 105 105 105 105 105 105 105 105 105 105 105 105 105 
2 64 65 3 2 3 2 3 2 3 2 3 2 3 0 1 0 1 2 3 2 3 2 3 2 64 65 3 2 3 105 105 
1 66 67 0 1 101 102 0 1 0 1 0 1 0 1 0 1 0 1 0 1 0 1 0 1 66 67 0 1 0 105 105 
0 68 69 1 0 103 104 1 0 1 0 1 0 1 0 1 0 1 0 1 0 1 0 1 0 68 69 1 0 1 105 105 
105 105 105 105 105 105 105 105 105 105 105 105 105 105 1 0 1 0 105 105 105 105 105 105 105 105 105 105 105 105 105 105 
2 3 2 3 2 3 2 3 2 64 65 3 2 3 0 1 0 1 2 3 2 3 2 3 2 98 98 3 2 3 105 105 
1 0 1 0 1 0 1 0 1 66 67 0 1 0 1 0 1 0 1 0 1 0 1 0 1 100 99 0 1 0 105 105 
0 1 0 1 0 1 0 1 0 68 69 1 0 1 0 1 0 1 0 1 0 1 0 1 0 1 100 1 0 1 105 105 
105 105 105 105 105 105 105 105 105 105 105 105 105 105 1 0 1 0 105 105 105 105 105 105 105 105 105 105 105 105 105 105 
2 64 65 3 2 98 98 3 2 3 2 3 2 3 0 1 0 1 2 3 2 64 65 3 2 3 2 3 2 3 105 105 
1 66 67 0 1 100 99 0 1 0 1 0 1 0 1 0 1 0 1 0 1 66 67 0 1 101 102 0 1 0 105 105 
0 68 69 1 0 1 100 1 0 1 0 1 0 1 0 1 0 1 0 1 0 68 69 1 0 103 104 1 0 1 105 105 
105 105 105 105 105 105 105 105 105 105 105 105 105 105 1 0 1 0 105 105 105 105 105 105 105 105 105 105 105 105 105 105 
105 105 2 3 2 3 2 3 2 3 2 3 2 3 0 1 0 1 2 3 2 3 2 3 2 3 2 3 2 3 105 105 
105 105 1 0 1 0 1 0 1 0 1 0 1 0 1 0 1 0 1 0 1 0 1 0 1 0 1 0 1 0 105 105 
105 105 0 1 0 1 0 1 0 1 0 1 0 1 0 1 0 1 0 1 0 1 0 1 0 1 0 1 0 1 105 105 
105 105 1 0 1 0 1 0 1 0 1 0 1 0 1 0 1 0 1 0 1 0 1 0 1 0 1 0 1 0 105 105 

11 
KEYDOOR 320 128 1
STONE 352 16 0
STONE 384 144 -3
STONE 128 208 0
ENEMY HEAD 64 16 0
ENEMY HEAD 448 80 1
ENEMY HEAD 384 208 1
ENEMY BAT 192 128
ENEMY BAT 288 128
ENEMY BAT 128 256
ENEMY BAT 384 256
