32 20
0 1 0 1 0 1 0 1 0 1 0 1 0 1 0 1 0 1 0 1 0 1 0 1 0 1 0 1 0 1 105 105 
1 0 1 0 1 0 1 0 1 0 1 0 1 0 1 0 1 0 1 0 1 0 1 0 1 0 1 0 1 0 105 105 
0 1 0 1 0 1 0 1 0 1 0 1 0 1 0 1 0 1 0 1 0 1 0 1 0 1 0 1 0 1 105 105 
105 105 105 105 105 105 105 105 1 0 1 0 1 0 1 0 1 0 1 0 1 0 1 0 105 105 105 105 105 105 105 105 
2 3 2 3 2 3 2 3 0 1 0 1 0 1 0 1 0 1 0 1 0 1 0 1 2 3 2 3 2 3 105 105 
1 0 1 0 1 0 1 0 1 0 1 0 1 0 1 0 1 0 1 0 1 0 1 0 1 0 1 0 1 0 105 105 
0 1 0 1 0 1 0 1 0 1 0 1 0 1 0 1 0 1 0 1 0 1 0 1 0 1 0 1 0 1 105 105 
105 105 1 0 1 0 1 0 1 0 1 0 105 105 105 105 105 105 105 105 1 0 1 0 105 105 105 105 105 105 105 105 
105 105 0 1 0 1 0 1 0 1 0 1 2 3 2 3 2 3 2 3 0 1 0 1 2 3 2 3 2 3 105 105 
105 105 1 0 1 0 1 0 1 0 1 0 1 0 1 0 1 0 1 0 1 0 1 0 1 0 1 0 1 0 105 105 
105 105 0 1 0 1 0 1 0 1 0 1 0 1 0 1 0 1 0 1 0 1 0 1 0 1 0 1 0 1 105 105 
105 105 1 0 1 0 1 0 1 0 1 0 1 0 1 0 106 106 105 105 105 105 105 105 105 105 105 105 105 105 105 105 
105 105 0 1 0 1 0 1 0 1 0 1 0 1 0 1 2 3 2 3 2 3 2 3 2 3 2 3 2 3 105 105 
105 105 1 0 1 0 1 0 1 0 1 0 1 0 1 0 1 0 1 0 1 0 1 0 1 0 1 0 1 0 105 105 
105 105 0 1 0 1 0 1 0 1 0 1 0 1 0 1 0 1 0 1 0 1 0 1 0 1 0 1 0 1 105 105 
105 105 105 105 105 105 105 105 106 106 105 105 105 105 105 105 105 105 105 105 105 105 105 105 1 0 1 0 1 0 105 105 
105 105 2 3 2 94 95 3 2 3 2 3 2 3 2 3 2 94 95 3 2 3 2 3 0 1 0 1 0 1 2 3 
105 105 1 0 1 96 97 0 1 0 1 0 1 0 1 0 1 96 97 0 1 0 1 0 1 0 1 0 1 0 1 0 
105 105 0 1 0 1 0 1 0 1 0 1 0 1 0 1 0 1 0 1 0 1 0 1 0 1 0 1 0 1 0 1 
105 105 105 105 105 105 105 105 105 105 105 105 105 105 105 105 105 105 105 105 105 105 105 105 105 105 105 105 105 105 105 105 

14 
LADDER 128 256 3 0
LADDER 256 192 3 0
LADDER 256 0 7 0
STONE 384 144 0
STONE 288 272 0
STONE 64 16 -3
ENEMY HEAD 96 16 0
ENEMY HEAD 32 272 0
ENEMY HEAD 352 208 1
ENEMY HEAD 384 16 1
ENEMY WORM 288 144 0
ENEMY WORM 416 80 0
ENEMY WORM 320 208 0
ENEMY WORM 128 208 0
