32 20
105 105 50 51 48 49 50 51 48 49 50 51 48 49 50 51 48 49 50 51 48 49 50 51 48 49 50 51 48 49 105 105 
105 105 54 55 52 53 54 55 52 53 54 55 52 53 54 55 52 53 54 55 52 53 54 55 52 53 54 55 52 53 105 105 
105 105 58 59 56 57 58 59 56 57 58 59 56 57 58 59 56 57 58 59 56 57 58 59 56 57 58 59 56 57 105 105 
105 105 46 47 44 45 46 47 44 45 46 47 44 45 46 47 44 45 46 47 44 45 46 47 44 45 46 47 44 45 105 105 
105 105 50 51 48 49 50 51 48 49 50 51 48 49 50 51 48 49 50 51 48 49 50 51 48 49 50 51 48 49 105 105 
105 105 54 55 52 53 54 55 52 53 54 55 52 53 54 55 52 53 54 55 52 53 54 55 52 53 54 55 52 53 105 105 
105 105 58 59 56 57 58 59 56 57 58 59 56 57 58 59 56 57 58 59 56 57 58 59 56 57 58 59 56 57 105 105 
105 105 46 47 44 45 46 47 44 45 105 105 105 105 46 47 44 45 46 47 44 45 46 47 44 45 46 47 44 45 105 105 
105 105 50 51 48 49 50 51 48 49 50 51 48 49 50 51 48 49 50 51 48 49 50 51 48 49 50 51 48 49 105 105 
105 105 54 55 52 53 54 55 52 53 54 55 52 53 54 55 52 53 54 55 52 53 54 55 52 53 54 55 52 53 105 105 
105 105 58 59 56 57 58 59 56 57 58 59 56 57 58 59 56 57 58 59 56 57 58 59 56 57 58 59 56 57 105 105 
105 105 46 47 44 45 46 47 44 45 46 47 44 45 46 47 44 45 105 105 105 105 46 47 44 45 46 47 44 45 105 105 
105 105 50 51 48 49 50 51 48 49 50 51 48 49 50 51 48 49 50 51 48 49 50 51 48 49 50 51 48 49 105 105 
105 105 54 55 52 53 54 55 52 53 54 55 52 53 54 55 52 53 54 55 52 53 54 55 52 53 54 55 52 53 105 105 
105 105 58 59 56 57 58 59 56 57 58 59 56 57 58 59 56 57 58 59 56 57 58 59 56 57 58 59 56 57 105 105 
105 105 46 47 44 45 46 47 44 45 46 47 44 45 46 47 44 45 46 47 44 45 46 47 44 45 46 47 44 45 105 105 
105 105 50 51 48 49 50 51 48 49 50 51 48 49 50 51 48 49 50 51 48 49 50 51 48 49 50 51 48 49 105 105 
105 105 54 55 52 53 54 55 52 53 54 55 52 53 54 55 52 53 54 55 52 53 54 55 52 53 54 55 52 53 105 105 
105 105 58 59 56 57 58 59 56 57 58 59 56 57 58 59 56 57 58 59 56 57 58 59 56 57 58 59 56 57 105 105 
105 105 105 105 105 105 105 105 105 105 46 47 44 45 46 47 44 45 46 47 44 45 105 105 105 105 105 105 105 105 105 105 

2 
STONE 96 272 -1
ENEMY KNIGHT 384 272
