32 20
105 105 105 105 105 105 105 105 0 1 0 1 0 1 0 1 0 1 0 1 0 1 0 1 105 105 105 105 105 105 105 105 
105 105 105 105 105 105 105 105 1 0 1 0 1 0 1 0 1 0 1 0 1 0 1 0 105 105 105 105 105 105 105 105 
105 105 105 105 105 105 105 105 0 1 0 1 0 1 0 1 0 1 0 1 0 1 0 1 105 105 105 105 105 105 105 105 
105 105 105 105 105 105 105 105 1 0 1 0 106 106 105 105 105 105 105 105 105 105 105 105 105 105 105 105 105 105 105 105 
105 105 105 105 105 105 105 105 0 1 0 1 2 3 2 3 2 3 2 3 2 3 2 3 2 3 2 3 2 3 2 3 
105 105 105 105 105 105 105 105 1 0 1 0 1 0 1 0 1 0 1 0 1 0 1 0 1 0 1 0 1 0 1 0 
105 105 105 105 105 105 105 105 0 1 0 1 0 1 0 1 0 1 0 1 0 1 0 1 0 1 0 1 0 1 0 1 
105 105 105 105 105 105 105 105 1 0 1 0 1 0 1 0 105 105 105 105 105 105 105 105 1 0 1 0 1 0 1 0 
105 105 105 105 105 105 105 105 0 1 0 1 0 1 0 1 105 105 105 105 105 105 105 105 0 1 0 1 0 1 0 1 
105 105 105 105 105 105 105 105 1 0 1 0 1 0 1 0 105 105 105 105 105 105 105 105 1 0 1 0 1 0 1 0 
105 105 105 105 105 105 105 105 0 1 0 1 0 1 0 1 105 105 105 105 105 105 105 105 0 1 0 1 0 1 0 1 
105 105 105 105 105 105 105 105 105 105 105 105 105 105 105 105 105 105 105 105 105 105 105 105 105 105 105 105 105 105 105 105 
105 105 105 105 105 105 105 105 105 105 105 105 105 105 105 105 105 105 105 105 105 105 105 105 105 105 105 105 105 105 105 105 
105 105 105 105 105 105 105 105 105 105 105 105 105 105 105 105 105 105 105 105 105 105 105 105 105 105 105 105 105 105 105 105 
105 105 105 105 105 105 105 105 105 105 105 105 105 105 105 105 105 105 105 105 105 105 105 105 105 105 105 105 105 105 105 105 
105 105 105 105 105 105 105 105 105 105 105 105 105 105 105 105 105 105 105 105 105 105 105 105 105 105 105 105 105 105 105 105 
105 105 105 105 105 105 105 105 105 105 105 105 105 105 105 105 105 105 105 105 105 105 105 105 105 105 105 105 105 105 105 105 
105 105 105 105 105 105 105 105 105 105 105 105 105 105 105 105 105 105 105 105 105 105 105 105 105 105 105 105 105 105 105 105 
105 105 105 105 105 105 105 105 105 105 105 105 105 105 105 105 105 105 105 105 105 105 105 105 105 105 105 105 105 105 105 105 
105 105 105 105 105 105 105 105 105 105 105 105 105 105 105 105 105 105 105 105 105 105 105 105 105 105 105 105 105 105 105 105 

11 
LADDER 192 64 7 0
LADDER 288 0 3 0
STONE 416 144 0
ENEMY WORM 384 144 0
ENEMY WORM 320 80 0
ENEMY WORM 224 144 0
ENEMY WORM 128 144 0
ENEMY WORM 352 16 0
ENEMY SPIDER 224 0
ENEMY SPIDER 352 64
ENEMY SPIDER 288 64
