32 20
105 105 50 51 48 49 50 51 48 49 50 51 48 49 50 51 48 49 50 51 48 49 50 51 48 49 50 51 48 49 105 105 
105 105 54 55 52 53 54 55 52 53 54 55 52 53 54 55 52 53 54 55 52 53 54 55 52 53 54 55 52 53 105 105 
105 105 58 59 56 57 58 59 56 57 58 59 56 57 58 59 56 57 58 59 56 57 58 59 56 57 58 59 56 57 105 105 
105 105 105 105 105 105 105 105 44 45 46 47 105 105 105 105 105 105 105 105 44 45 46 47 44 45 46 47 44 45 105 105 
105 105 62 63 60 70 71 51 48 49 50 51 60 70 71 63 60 61 62 63 48 49 50 51 48 49 50 51 48 49 105 105 
105 105 54 55 52 72 73 55 52 53 54 55 52 72 73 55 52 53 54 55 52 53 54 55 52 53 54 55 52 53 105 105 
105 105 58 59 56 74 75 59 56 57 58 59 56 74 75 59 56 57 58 59 56 57 58 59 56 57 58 59 56 57 105 105 
105 105 105 105 105 105 105 105 44 45 46 47 105 105 105 105 105 105 46 47 44 45 105 105 105 105 106 106 44 45 105 105 
105 105 105 105 105 105 105 105 48 49 50 51 105 105 105 105 60 61 50 51 48 49 105 105 60 61 62 63 48 49 105 105 
105 105 105 105 105 105 105 105 52 53 54 55 105 105 105 105 52 53 54 55 52 53 105 105 52 53 54 55 52 53 105 105 
105 105 105 105 105 105 105 105 56 57 58 59 105 105 105 105 56 57 58 59 56 57 105 105 56 57 58 59 56 57 105 105 
105 105 105 105 105 105 105 105 44 45 46 47 105 105 105 105 105 105 105 105 44 45 105 105 44 45 46 47 44 45 105 105 
105 105 105 105 105 105 105 105 48 49 50 51 60 61 62 63 60 70 71 63 48 49 105 105 48 49 50 51 48 49 105 105 
105 105 105 105 105 105 105 105 52 53 54 55 52 53 54 55 52 72 73 55 52 53 105 105 52 53 54 55 52 53 105 105 
105 105 105 105 105 105 105 105 56 57 58 59 56 57 58 59 56 74 75 59 56 57 105 105 56 57 58 59 56 57 105 105 
105 105 105 105 105 105 105 105 44 45 46 47 44 45 105 105 105 105 105 105 105 105 105 105 44 45 46 47 44 45 105 105 
105 105 105 105 105 105 105 105 48 49 50 51 48 49 62 63 60 61 62 63 60 70 71 63 48 49 50 51 48 49 105 105 
105 105 105 105 105 105 105 105 52 53 54 55 52 53 54 55 52 53 54 55 52 72 73 55 52 53 54 55 52 53 105 105 
105 105 105 105 105 105 105 105 56 57 58 59 56 57 58 59 56 57 58 59 56 74 75 59 56 57 58 59 56 57 105 105 
105 105 105 105 105 105 105 105 44 45 46 47 105 105 105 105 105 105 105 105 105 105 105 105 105 105 105 105 105 105 105 105 

10 
LADDER 416 128 11 0
LADDER 352 0 7 0
LADDER 192 0 3 0
STONE 256 144 -1
STONE 32 80 0
STONE 384 80 0
ENEMY SMOKE 96 80 0
ENEMY SMOKE 416 80 0
ENEMY SMOKE 256 16 0
ENEMY SMOKE 224 192 1
