32 20
4 5 6 7 4 5 6 7 4 5 6 7 4 5 6 7 4 5 6 7 4 5 6 7 4 5 6 7 4 5 105 105 
8 9 10 11 8 9 10 11 8 9 10 11 8 9 10 11 8 9 10 11 8 9 10 11 8 9 10 11 8 9 105 105 
12 13 14 15 12 13 14 15 12 13 14 15 12 13 14 15 12 13 14 15 12 13 14 15 12 13 14 15 12 13 105 105 
105 105 105 105 105 105 105 105 105 105 105 105 105 105 105 105 105 105 105 105 105 105 106 106 105 105 105 105 105 105 105 105 
105 105 22 23 20 21 22 23 20 21 22 23 20 21 22 23 20 21 22 23 20 21 22 23 20 21 22 23 20 21 105 105 
105 105 10 11 8 9 10 11 8 9 10 11 8 9 10 11 8 9 10 11 8 9 10 11 8 9 10 11 8 9 105 105 
105 105 14 15 12 13 14 15 12 13 14 15 12 13 14 15 12 13 14 15 12 13 14 15 12 13 14 15 12 13 105 105 
105 105 18 19 16 17 18 19 16 17 18 19 16 17 18 19 16 17 18 19 16 17 18 19 16 17 18 19 16 17 105 105 
20 21 6 7 4 5 6 7 4 5 6 7 4 5 6 7 4 5 6 7 4 5 6 7 4 5 6 7 4 5 105 105 
8 9 10 11 8 9 10 11 8 9 10 11 8 9 10 11 8 9 10 11 8 9 10 11 8 9 10 11 8 9 105 105 
12 13 14 15 12 13 14 15 12 13 14 15 12 13 14 15 12 13 14 15 12 13 14 15 12 13 14 15 12 13 105 105 
105 105 18 19 105 105 18 19 16 17 18 19 16 17 18 19 16 17 18 19 105 105 105 105 16 17 18 19 16 17 105 105 
105 105 6 7 20 21 6 7 4 5 6 7 4 5 6 7 4 5 6 7 20 21 22 23 4 5 6 7 4 5 105 105 
105 105 10 11 8 9 10 11 8 9 10 11 8 9 10 11 8 9 10 11 8 9 10 11 8 9 10 11 8 9 105 105 
105 105 14 15 12 13 14 15 12 13 14 15 12 13 14 15 12 13 14 15 12 13 14 15 12 13 14 15 12 13 105 105 
105 105 18 19 16 17 18 19 16 17 18 19 16 17 18 19 16 17 18 19 16 17 18 19 16 17 18 19 16 17 105 105 
20 21 6 7 4 5 6 7 4 5 6 7 4 5 6 7 4 5 6 7 4 5 6 7 4 5 6 7 4 5 105 105 
8 9 10 11 8 9 10 11 8 9 10 11 8 9 10 11 8 9 10 11 8 9 10 11 8 9 10 11 8 9 105 105 
12 13 14 15 12 13 14 15 12 13 14 15 12 13 14 15 12 13 14 15 12 13 14 15 12 13 14 15 12 13 105 105 
105 105 18 19 105 105 18 19 16 17 18 19 16 17 18 19 16 17 18 19 16 17 18 19 16 17 18 19 16 17 105 105 

11 
LADDER 352 64 7 1
STONE 256 16 17
STONE 64 144 0
STONE 64 272 0
ENEMY BAT 64 192
ENEMY BAT 352 192
ENEMY BAT 384 64
ENEMY BAT 128 64
ENEMY BAMBU 64 16
ENEMY BAMBU 160 16
ENEMY BAMBU 320 16
