32 20
105 105 105 105 4 5 6 7 4 5 6 7 4 5 6 7 4 5 6 7 105 105 105 105 4 5 6 7 105 105 105 105 
105 105 105 105 8 9 10 11 8 9 10 11 8 9 10 11 8 9 10 11 105 105 105 105 8 9 10 11 105 105 105 105 
105 105 105 105 12 13 14 15 12 13 14 15 12 13 14 15 12 13 14 15 105 105 105 105 12 13 14 15 105 105 105 105 
105 105 105 105 16 17 18 19 105 105 105 105 105 105 105 105 105 105 105 105 105 105 105 105 16 17 18 19 105 105 105 105 
105 105 105 105 4 5 6 7 105 105 105 105 105 105 105 105 105 105 105 105 105 105 105 105 4 5 6 7 105 105 105 105 
105 105 105 105 8 9 10 11 105 105 105 105 105 105 105 105 105 105 105 105 105 105 105 105 8 9 10 11 105 105 105 105 
105 105 105 105 12 13 14 15 105 105 105 105 105 105 105 105 105 105 105 105 105 105 105 105 12 13 14 15 105 105 105 105 
105 105 105 105 105 105 18 19 105 105 105 105 105 105 105 105 105 105 105 105 105 105 105 105 16 17 18 19 105 105 105 105 
105 105 105 105 105 105 6 7 20 155 156 21 20 21 20 21 20 155 156 21 20 21 20 21 4 5 6 7 105 105 105 105 
105 105 105 105 105 105 10 11 8 157 158 11 8 9 10 11 8 157 158 11 8 9 10 11 8 9 10 11 105 105 105 105 
105 105 105 105 105 105 14 15 12 159 160 15 12 13 14 15 12 159 160 15 12 13 14 15 12 13 14 15 105 105 105 105 
105 105 105 105 105 105 105 105 105 105 105 105 106 106 18 19 105 105 105 105 105 105 105 105 105 105 105 105 105 105 105 105 
105 105 105 105 105 105 105 105 105 105 105 105 20 21 6 7 105 105 105 105 105 105 105 105 105 105 105 105 105 105 105 105 
105 105 105 105 105 105 105 105 105 105 105 105 8 9 10 11 105 105 105 105 105 105 105 105 105 105 105 105 105 105 105 105 
105 105 105 105 105 105 105 105 105 105 105 105 12 13 14 15 105 105 105 105 105 105 105 105 105 105 105 105 105 105 105 105 
105 105 105 105 105 105 105 105 105 105 105 105 16 17 18 19 105 105 105 105 105 105 105 105 105 105 105 105 105 105 105 105 
105 105 20 21 20 155 156 21 20 21 20 21 4 5 6 7 20 155 156 21 20 21 20 21 20 21 20 21 105 105 105 105 
105 105 10 11 8 157 158 11 8 9 10 11 8 9 10 11 8 157 158 11 8 9 10 11 8 9 10 11 105 105 105 105 
105 105 14 15 12 159 160 15 12 13 14 15 12 13 14 15 12 159 160 15 12 13 14 15 12 13 14 15 105 105 105 105 
105 105 105 105 105 105 105 105 105 105 105 105 105 105 105 105 105 105 105 105 105 105 105 105 16 17 18 19 105 105 105 105 

12 
LADDER 192 0 3 0
LADDER 192 192 7 0
LADDER 416 0 11 0
STONE 64 80 0
STONE 304 144 0
ENEMY PORCUPINE 144 16
ENEMY PORCUPINE 96 272
ENEMY PORCUPINE 384 144
ENEMY BAMBU 128 16
ENEMY BAMBU 192 144
ENEMY BAMBU 256 272
ENEMY BAMBU 352 144
