32 20
48 49 50 51 48 49 50 51 48 49 50 51 105 105 105 105 105 105 105 105 105 105 105 105 105 105 105 105 105 105 50 51 
52 53 54 55 52 53 54 55 52 53 54 55 105 105 105 105 105 105 105 105 105 105 105 105 105 105 105 105 105 105 54 55 
56 57 58 59 56 57 58 59 56 57 58 59 105 105 105 105 105 105 105 105 105 105 105 105 105 105 105 105 105 105 58 59 
105 105 105 105 105 105 106 106 44 45 46 47 105 105 105 105 105 105 105 105 105 105 105 105 105 105 105 105 105 105 46 47 
60 70 71 63 60 61 62 63 48 49 50 51 60 61 62 63 60 61 62 63 60 70 71 63 60 61 62 63 60 61 50 51 
52 72 73 55 52 53 54 55 52 53 54 55 52 53 54 55 52 53 54 55 52 72 73 55 52 53 54 55 52 53 54 55 
56 74 75 59 56 57 58 59 56 57 58 59 56 57 58 59 56 57 58 59 56 74 75 59 56 57 58 59 56 57 58 59 
105 105 105 105 105 105 106 106 44 45 46 47 44 45 105 105 105 105 105 105 105 105 105 105 105 105 105 105 44 45 46 47 
60 61 62 63 60 61 62 63 48 49 50 51 48 49 62 63 60 70 71 63 60 61 62 63 60 70 71 63 48 49 50 51 
52 53 54 55 52 53 54 55 52 53 54 55 52 53 54 55 52 72 73 55 52 53 54 55 52 72 73 55 52 53 54 55 
56 57 58 59 56 57 58 59 56 57 58 59 56 57 58 59 56 74 75 59 56 57 58 59 56 74 75 59 56 57 58 59 
105 105 105 105 105 105 106 106 44 45 46 47 105 105 105 105 105 105 105 105 44 45 105 105 105 105 105 105 105 105 105 105 
60 70 71 63 60 61 62 63 48 49 50 51 60 61 62 63 60 61 62 63 48 49 62 63 60 70 71 63 60 61 62 63 
52 72 73 55 52 53 54 55 52 53 54 55 52 53 54 55 52 53 54 55 52 53 54 55 52 72 73 55 52 53 54 55 
56 74 75 59 56 57 58 59 56 57 58 59 56 57 58 59 56 57 58 59 56 57 58 59 56 74 75 59 56 57 58 59 
105 105 105 105 105 105 106 106 44 45 46 47 44 45 105 105 105 105 105 105 105 105 105 105 105 105 105 105 44 45 46 47 
60 61 62 63 60 61 62 63 48 49 50 51 48 49 105 105 105 105 105 105 105 105 105 105 105 105 105 105 48 49 50 51 
52 53 54 55 52 53 54 55 52 53 54 55 52 53 105 105 105 105 105 105 105 105 105 105 105 105 105 105 52 53 54 55 
56 57 58 59 56 57 58 59 56 57 58 59 56 57 105 105 105 105 105 105 105 105 105 105 105 105 105 105 56 57 58 59 
105 105 105 105 105 105 105 105 105 105 105 105 105 105 105 105 105 105 105 105 105 105 105 105 105 105 105 105 105 105 105 105 

16 
LADDER 96 64 3 0
LADDER 96 128 3 0
LADDER 96 192 3 0
LADDER 96 256 3 0
KEYDOOR 272 192 1
STONE 160 272 0
STONE 368 208 0
STONE 64 16 -2
ENEMY BAT 64 64
ENEMY BAT 64 256
ENEMY BAT 224 192
ENEMY BAT 224 64
ENEMY BAT 256 128
ENEMY BAT 384 128
ENEMY BAT 416 192
ENEMY BAT 416 64
