32 20
105 105 6 7 4 5 6 7 4 5 6 7 4 5 6 7 4 5 6 7 4 5 6 7 4 5 6 7 4 5 105 105 
105 105 10 11 8 9 10 11 8 9 10 11 8 9 10 11 8 9 10 11 8 9 10 11 8 9 10 11 8 9 105 105 
105 105 14 15 12 13 14 15 12 13 14 15 12 13 14 15 12 13 14 15 12 13 14 15 12 13 14 15 12 13 105 105 
105 105 105 105 106 106 105 105 105 105 105 105 105 105 18 19 16 17 105 105 105 105 105 105 105 105 106 106 105 105 105 105 
105 105 22 23 20 21 22 23 20 21 22 23 20 21 6 7 4 5 22 23 20 21 22 23 20 21 22 23 20 21 105 105 
105 105 10 11 8 9 10 11 8 9 10 11 8 9 10 11 8 9 10 11 8 9 10 11 8 9 10 11 8 9 105 105 
105 105 14 15 12 13 14 15 12 13 14 15 12 13 14 15 12 13 14 15 12 13 14 15 12 13 14 15 12 13 105 105 
105 105 105 105 105 105 105 105 105 105 105 105 105 105 18 19 16 17 105 105 105 105 105 105 105 105 105 105 105 105 105 105 
105 105 22 23 20 155 156 23 20 21 22 23 20 21 6 7 4 5 22 23 20 21 22 23 20 155 156 23 20 21 105 105 
105 105 10 11 8 157 158 11 8 9 10 11 8 9 10 11 8 9 10 11 8 9 10 11 8 157 158 11 8 9 105 105 
105 105 14 15 12 159 160 15 12 13 14 15 12 13 14 15 12 13 14 15 12 13 14 15 12 159 160 15 12 13 105 105 
105 105 105 105 105 105 105 105 105 105 105 105 105 105 18 19 16 17 105 105 105 105 106 106 105 105 105 105 105 105 105 105 
105 105 22 23 20 21 22 23 20 155 156 23 20 21 6 7 4 5 22 23 20 21 22 23 20 21 22 23 20 21 105 105 
105 105 10 11 8 9 10 11 8 157 158 11 8 9 10 11 8 9 10 11 8 9 10 11 8 9 10 11 8 9 105 105 
105 105 14 15 12 13 14 15 12 159 160 15 12 13 14 15 12 13 14 15 12 13 14 15 12 13 14 15 12 13 105 105 
105 105 105 105 105 105 105 105 106 106 105 105 105 105 18 19 16 17 105 105 105 105 105 105 105 105 105 105 105 105 105 105 
105 105 22 23 20 155 156 23 20 21 22 23 20 21 6 7 4 5 22 23 20 21 22 23 20 155 156 23 20 21 105 105 
105 105 10 11 8 157 158 11 8 9 10 11 8 9 10 11 8 9 10 11 8 9 10 11 8 157 158 11 8 9 105 105 
105 105 14 15 12 159 160 15 12 13 14 15 12 13 14 15 12 13 14 15 12 13 14 15 12 159 160 15 12 13 105 105 
105 105 105 105 105 105 105 105 105 105 105 105 16 17 18 19 16 17 18 19 105 105 105 105 105 105 105 105 105 105 105 105 

11 
LADDER 416 64 3 0
LADDER 352 192 3 0
LADDER 128 256 3 0
LADDER 64 64 3 0
STONE 80 272 0
STONE 320 80 0
STONE 400 208 -1
ENEMY KNIGHT 416 144
ENEMY KNIGHT 416 16
ENEMY KNIGHT 96 80
ENEMY KNIGHT 96 208
