32 20
105 105 105 105 0 1 0 1 0 1 0 1 0 1 0 1 0 1 105 105 0 1 0 1 0 1 0 1 105 105 105 105 
105 105 105 105 1 0 1 0 1 0 1 0 1 0 1 0 1 0 105 105 1 0 1 0 1 0 1 0 105 105 105 105 
105 105 105 105 0 1 0 1 0 1 0 1 0 1 0 1 0 1 105 105 0 1 0 1 0 1 0 1 105 105 105 105 
105 105 105 105 1 0 1 0 105 105 105 105 105 105 105 105 1 0 105 105 1 0 105 105 1 0 1 0 105 105 105 105 
105 105 105 105 0 1 0 1 2 3 2 3 105 105 2 3 0 1 105 105 0 1 2 3 0 1 0 1 105 105 105 105 
105 105 105 105 1 0 1 0 1 0 1 0 105 105 1 0 1 0 105 105 1 0 1 0 1 0 1 0 105 105 105 105 
105 105 105 105 0 1 0 1 0 1 0 1 105 105 0 1 0 1 105 105 0 1 0 1 0 1 0 1 105 105 105 105 
105 105 105 105 1 0 1 0 105 105 105 105 105 105 105 105 1 0 105 105 1 0 1 0 105 105 1 0 105 105 105 105 
105 105 105 105 0 1 0 1 2 3 2 3 2 3 2 3 0 1 105 105 0 1 0 1 2 3 0 1 2 3 2 3 
105 105 105 105 1 0 1 0 1 0 1 0 1 0 1 0 1 0 105 105 1 0 1 0 1 0 1 0 1 0 1 0 
105 105 105 105 0 1 0 1 0 1 0 1 0 1 0 1 0 1 105 105 0 1 0 1 0 1 0 1 0 1 0 1 
105 105 105 105 1 0 1 0 1 0 1 0 1 0 105 105 1 0 105 105 1 0 1 0 1 0 1 0 105 105 105 105 
105 105 105 105 0 1 0 1 0 1 0 1 0 1 2 3 0 1 2 3 0 1 0 1 0 1 0 1 105 105 105 105 
105 105 105 105 1 0 1 0 1 0 1 0 1 0 1 0 1 0 1 0 1 0 1 0 1 0 1 0 105 105 105 105 
105 105 105 105 0 1 0 1 0 1 0 1 0 1 0 1 0 1 0 1 0 1 0 1 0 1 0 1 105 105 105 105 
105 105 105 105 1 0 1 0 1 0 1 0 1 0 1 0 1 0 105 105 1 0 1 0 1 0 1 0 105 105 105 105 
105 105 105 105 163 163 163 163 163 163 163 163 163 163 163 163 163 163 163 163 163 163 163 163 163 163 163 163 105 105 105 105 
105 105 105 105 164 164 164 164 164 164 164 164 164 164 164 164 164 164 164 164 164 164 164 164 164 164 164 164 105 105 105 105 
105 105 105 105 164 164 164 164 164 164 164 164 164 164 164 164 164 164 164 164 164 164 164 164 164 164 164 164 105 105 105 105 
105 105 105 105 105 105 105 105 105 105 105 105 105 105 105 105 105 105 105 105 105 105 105 105 105 105 105 105 105 105 105 105 

1 
STONE 160 80 37
