32 20
105 105 0 1 0 1 0 1 0 1 0 1 0 1 0 1 0 1 0 1 0 1 0 1 0 1 0 1 0 1 105 105 
105 105 1 0 1 0 1 0 1 0 1 0 1 0 1 0 1 0 1 0 1 0 1 0 1 0 1 0 1 0 105 105 
105 105 0 1 0 1 0 1 0 1 0 1 0 1 0 1 0 1 0 1 0 1 0 1 0 1 0 1 0 1 105 105 
105 105 105 105 105 105 105 105 105 105 1 0 1 0 105 105 105 105 105 105 105 105 105 105 105 105 105 105 105 105 105 105 
105 105 2 3 2 76 77 3 2 3 0 1 0 1 2 3 2 3 2 3 2 94 95 3 2 3 2 3 2 3 105 105 
105 105 1 0 1 78 79 0 1 0 1 0 1 0 1 0 1 0 1 0 1 96 97 0 1 0 1 0 1 0 105 105 
105 105 0 1 0 80 81 1 0 1 0 1 0 1 0 1 0 1 0 1 0 1 0 1 0 1 0 1 0 1 105 105 
105 105 105 105 105 105 105 105 105 105 105 105 105 105 105 105 1 0 1 0 105 105 106 106 105 105 105 105 105 105 105 105 
105 105 105 105 105 105 105 105 105 105 105 105 105 105 105 105 0 1 0 1 2 3 2 3 105 105 105 105 105 105 105 105 
105 105 105 105 105 105 105 105 105 105 105 105 105 105 105 105 1 0 1 0 1 0 1 0 105 105 105 105 105 105 105 105 
105 105 105 105 105 105 105 105 105 105 105 105 105 105 105 105 0 1 0 1 0 1 0 1 105 105 105 105 105 105 105 105 
105 105 105 105 105 105 105 105 105 105 105 105 105 105 105 105 1 0 1 0 1 0 1 0 105 105 105 105 105 105 105 105 
105 105 105 105 105 105 105 105 82 83 2 3 2 94 95 3 0 1 0 1 0 1 0 1 105 105 105 105 105 105 105 105 
105 105 105 105 105 105 105 105 84 85 1 0 1 96 97 0 1 0 1 0 1 0 1 0 105 105 105 105 105 105 105 105 
105 105 105 105 105 105 105 105 86 87 0 1 0 1 0 1 0 1 0 1 0 1 0 1 105 105 105 105 105 105 105 105 
105 105 105 105 105 105 105 105 105 105 106 106 105 105 105 105 1 0 1 0 105 105 105 105 105 105 105 105 105 105 105 105 
105 105 105 105 105 105 105 105 2 3 2 3 2 3 2 3 0 1 0 1 2 3 2 3 2 76 77 3 2 3 105 105 
105 105 105 105 105 105 105 105 1 0 1 0 1 0 1 0 1 0 1 0 1 0 1 0 1 78 79 0 1 0 105 105 
105 105 105 105 105 105 105 105 0 1 0 1 0 1 0 1 0 1 0 1 0 1 0 1 0 80 81 1 0 1 105 105 
105 105 105 105 105 105 105 105 1 0 1 0 1 0 1 0 1 0 1 0 1 0 1 0 105 105 105 105 105 105 105 105 

10 
LADDER 256 0 3 0
LADDER 352 128 7 0
LADDER 160 256 5 0
STONE 160 80 0
STONE 448 80 -2
ENEMY WORM 64 16 0
ENEMY WORM 96 80 0
ENEMY WORM 416 80 0
ENEMY WORM 416 16 0
ENEMY WORM 176 208 0
