32 20
105 105 105 105 105 105 105 105 105 105 105 105 105 105 105 105 105 105 105 105 105 105 105 105 105 105 105 105 105 105 105 105 
105 105 105 105 105 105 105 105 105 105 105 105 105 105 105 105 105 105 105 105 105 105 105 105 105 105 105 105 105 105 105 105 
105 105 105 105 105 105 105 105 105 105 105 105 105 105 105 105 105 105 105 105 105 105 105 105 105 105 105 105 105 105 105 105 
105 105 105 105 105 105 105 105 105 105 105 105 105 105 105 105 105 105 105 105 105 105 105 105 105 105 105 105 105 105 105 105 
105 105 105 105 105 105 105 105 105 105 105 105 105 105 105 105 105 105 105 105 105 105 105 105 105 105 105 105 105 105 105 105 
105 105 105 105 105 105 105 105 105 105 105 105 105 105 105 105 105 105 105 105 105 105 105 105 105 105 105 105 105 105 105 105 
105 105 105 105 105 105 105 105 105 105 105 105 105 105 105 105 105 105 105 105 105 105 105 105 105 105 105 105 105 105 105 105 
105 105 105 105 105 105 105 105 105 105 105 105 105 105 105 105 105 105 105 105 105 105 105 105 105 105 105 105 105 105 105 105 
105 105 62 63 60 70 71 63 60 61 62 63 60 70 71 63 60 61 62 63 60 70 71 63 60 61 62 63 60 61 105 105 
105 105 54 55 52 72 73 55 52 53 54 55 52 72 73 55 52 53 54 55 52 72 73 55 52 53 54 55 52 53 105 105 
105 105 58 59 56 74 75 59 56 57 58 59 56 74 75 59 56 57 58 59 56 74 75 59 56 57 58 59 56 57 105 105 
105 105 105 105 105 105 105 105 105 105 105 105 105 105 105 105 105 105 105 105 105 105 105 105 105 105 106 106 105 105 105 105 
105 105 62 63 60 61 62 63 60 61 62 63 60 61 62 63 60 70 71 63 60 61 62 63 60 61 62 63 60 61 105 105 
105 105 54 55 52 53 54 55 52 53 54 55 52 53 54 55 52 72 73 55 52 53 54 55 52 53 54 55 52 53 105 105 
105 105 58 59 56 57 58 59 56 57 58 59 56 57 58 59 56 74 75 59 56 57 58 59 56 57 58 59 56 57 105 105 
105 105 105 105 105 105 106 106 44 45 46 47 105 105 105 105 105 105 105 105 105 105 105 105 105 105 106 106 105 105 105 105 
105 105 62 63 60 61 62 63 48 49 50 51 60 70 71 63 60 61 62 63 60 70 71 63 60 61 62 63 60 61 105 105 
105 105 54 55 52 53 54 55 52 53 54 55 52 72 73 55 52 53 54 55 52 72 73 55 52 53 54 55 52 53 105 105 
105 105 58 59 56 57 58 59 56 57 58 59 56 74 75 59 56 57 58 59 56 74 75 59 56 57 58 59 56 57 105 105 
105 105 46 47 44 45 46 47 44 45 46 47 105 105 105 105 44 45 46 47 105 105 105 105 105 105 105 105 105 105 105 105 

11 
LADDER 96 256 5 0
LADDER 416 256 3 0
LADDER 416 192 3 0
WDOOR 128 128 1
ENEMY SMOKE 320 128 1
ENEMY SMOKE 320 192 1
ENEMY SMOKE 224 256 1
ENEMY SMOKE 96 208 0
ENEMY SMOKE 224 144 0
ENEMY SMOKE 384 144 0
ENEMY SMOKE 384 272 0
