32 20
105 105 105 105 105 105 105 105 4 5 6 7 4 5 6 7 4 5 6 7 4 5 6 7 4 5 6 7 4 5 6 7 
105 105 105 105 105 105 105 105 8 9 10 11 8 9 10 11 8 9 10 11 8 9 10 11 8 9 10 11 8 9 10 11 
105 105 105 105 105 105 105 105 12 13 14 15 12 13 14 15 12 13 14 15 12 13 14 15 12 13 14 15 12 13 14 15 
105 105 105 105 105 105 105 105 105 105 105 105 105 105 105 105 105 105 105 105 106 106 105 105 105 105 105 105 105 105 105 105 
20 155 156 21 20 21 20 21 105 105 105 105 105 105 105 105 20 21 20 21 20 21 20 21 105 105 105 105 105 105 105 105 
8 157 158 11 8 9 10 11 105 105 105 105 105 105 105 105 8 9 10 11 8 9 10 11 105 105 105 105 105 105 105 105 
12 159 160 15 12 13 14 15 105 105 105 105 105 105 105 105 12 13 14 15 12 13 14 15 105 105 105 105 105 105 105 105 
105 105 105 105 105 105 105 105 105 105 105 105 105 105 105 105 105 105 105 105 105 105 105 105 105 105 105 105 105 105 105 105 
105 105 105 105 105 105 105 105 20 21 20 21 20 21 20 21 105 105 105 105 105 105 105 105 20 21 20 21 105 105 105 105 
105 105 105 105 105 105 105 105 8 9 10 11 8 9 10 11 105 105 105 105 105 105 105 105 8 9 10 11 105 105 105 105 
105 105 105 105 105 105 105 105 12 13 14 15 12 13 14 15 105 105 105 105 105 105 105 105 12 13 14 15 105 105 105 105 
105 105 105 105 105 105 105 105 16 17 18 19 105 105 105 105 105 105 105 105 105 105 105 105 105 105 18 19 105 105 105 105 
20 21 20 21 20 155 156 21 4 5 6 7 20 21 20 21 20 21 20 21 20 21 20 21 20 21 6 7 20 155 156 21 
8 9 10 11 8 157 158 11 8 9 10 11 8 9 10 11 8 9 10 11 8 9 10 11 8 9 10 11 8 157 158 11 
12 13 14 15 12 159 160 15 12 13 14 15 12 13 14 15 12 13 14 15 12 13 14 15 12 13 14 15 12 159 160 15 
105 105 105 105 105 105 105 105 105 105 105 105 105 105 105 105 105 105 105 105 105 105 105 105 105 105 105 105 105 105 105 105 
20 155 156 21 20 21 20 21 20 21 20 21 20 155 156 21 20 21 20 21 20 21 20 21 20 155 156 21 20 21 20 21 
8 157 158 11 8 9 10 11 8 9 10 11 8 157 158 11 8 9 10 11 8 9 10 11 8 157 158 11 8 9 10 11 
12 159 160 15 12 13 14 15 12 13 14 15 12 159 160 15 12 13 14 15 12 13 14 15 12 159 160 15 12 13 14 15 
105 105 105 105 105 105 105 105 105 105 105 105 105 105 105 105 105 105 105 105 105 105 105 105 105 105 105 105 105 105 105 105 

9 
LADDER 320 64 3 0
LADDER 384 0 3 0
KEYDOOR 256 192 1
STONE 224 144 14
STONE 256 16 0
STONE 272 272 0
ENEMY BAMBU 128 208
ENEMY BAMBU 224 16
ENEMY BAMBU 224 272
