32 20
48 49 50 51 48 49 50 51 48 49 50 51 48 49 50 51 48 49 50 51 48 49 50 51 105 105 105 105 105 105 105 105 
52 53 54 55 52 53 54 55 52 53 54 55 52 53 54 55 52 53 54 55 52 53 54 55 105 105 105 105 105 105 105 105 
56 57 58 59 56 57 58 59 56 57 58 59 56 57 58 59 56 57 58 59 56 57 58 59 105 105 105 105 105 105 105 105 
44 45 46 47 105 105 105 105 44 45 46 47 44 45 46 47 44 45 46 47 44 45 46 47 105 105 105 105 105 105 105 105 
48 49 50 51 60 61 62 63 48 49 50 51 48 49 50 51 48 49 50 51 48 49 50 51 60 61 62 63 60 61 105 105 
52 53 54 55 52 53 54 55 52 53 54 55 52 53 54 55 52 53 54 55 52 53 54 55 52 53 54 55 52 53 105 105 
56 57 58 59 56 57 58 59 56 57 58 59 56 57 58 59 56 57 58 59 56 57 58 59 56 57 58 59 56 57 105 105 
44 45 46 47 44 45 46 47 105 105 106 106 105 105 105 105 105 105 105 105 105 105 46 47 44 45 46 47 44 45 105 105 
48 49 50 51 48 49 50 51 60 61 62 63 60 70 71 63 60 61 62 63 60 61 50 51 48 49 50 51 48 49 105 105 
52 53 54 55 52 53 54 55 52 53 54 55 52 72 73 55 52 53 54 55 52 53 54 55 52 53 54 55 52 53 105 105 
56 57 58 59 56 57 58 59 56 57 58 59 56 74 75 59 56 57 58 59 56 57 58 59 56 57 58 59 56 57 105 105 
105 105 105 105 105 105 106 106 105 105 105 105 105 105 105 105 44 45 46 47 105 105 105 105 106 106 105 105 105 105 105 105 
105 105 62 63 60 61 62 63 60 70 71 63 60 61 62 63 48 49 50 51 60 70 71 63 60 61 62 63 60 61 105 105 
105 105 54 55 52 53 54 55 52 72 73 55 52 53 54 55 52 53 54 55 52 72 73 55 52 53 54 55 52 53 105 105 
105 105 58 59 56 57 58 59 56 74 75 59 56 57 58 59 56 57 58 59 56 74 75 59 56 57 58 59 56 57 105 105 
105 105 105 105 105 105 105 105 105 105 105 105 105 105 105 105 105 105 105 105 105 105 105 105 105 105 105 105 105 105 105 105 
105 105 105 105 105 105 105 105 105 105 105 105 105 105 105 105 105 105 105 105 105 105 105 105 105 105 105 105 105 105 105 105 
105 105 105 105 105 105 105 105 105 105 105 105 105 105 105 105 105 105 105 105 105 105 105 105 105 105 105 105 105 105 105 105 
105 105 105 105 105 105 105 105 105 105 105 105 105 105 105 105 105 105 105 105 105 105 105 105 105 105 105 105 105 105 105 105 
105 105 105 105 105 105 105 105 105 105 105 105 105 105 105 105 105 105 105 105 105 105 105 105 105 105 105 105 105 105 105 105 

10 
LADDER 384 192 3 0
LADDER 96 192 3 0
LADDER 160 128 3 0
LADDER 192 0 7 0
STONE 256 80 0
STONE 192 208 0
STONE 448 144 -2
ENEMY KNIGHT 384 144
ENEMY KNIGHT 160 80
ENEMY KNIGHT 128 208

APPEARWALL 13 8