32 20
36 37 38 39 36 37 38 39 36 37 38 39 36 37 38 39 36 37 38 39 36 37 38 39 36 37 38 39 36 37 38 39 
24 25 26 27 24 25 26 27 24 25 26 27 24 25 26 27 24 25 26 27 24 25 26 27 24 25 26 27 24 25 26 27 
28 29 30 31 28 29 30 31 28 29 30 31 28 29 30 31 28 29 30 31 28 29 30 31 28 29 30 31 28 29 30 31 
105 105 105 105 105 105 105 105 105 105 105 105 105 105 105 105 105 105 105 105 105 105 105 105 105 105 105 105 105 105 105 105 
40 41 42 43 40 119 120 43 40 41 42 43 40 119 120 43 40 41 42 43 105 105 105 105 105 105 105 105 40 41 42 43 
24 25 26 27 24 121 122 27 24 25 26 27 24 121 122 27 24 25 26 27 105 105 105 105 105 105 105 105 24 25 26 27 
28 29 30 31 28 123 124 31 28 29 30 31 28 123 124 31 28 29 30 31 105 105 105 105 105 105 105 105 28 29 30 31 
105 105 105 105 105 105 105 105 105 105 105 105 105 105 105 105 105 105 105 105 105 105 105 105 105 105 105 105 105 105 105 105 
105 105 105 105 40 41 42 43 40 119 120 43 40 41 42 43 40 41 42 43 40 41 42 43 40 41 42 43 40 41 105 105
105 105 105 105 24 25 26 27 24 121 122 27 24 25 26 27 24 25 26 27 24 25 26 27 24 25 26 27 24 25 105 105
105 105 105 105 28 29 30 31 28 123 124 31 28 29 30 31 28 29 30 31 28 29 30 31 28 29 30 31 28 29 105 105 
105 105 105 105 105 105 105 105 105 105 105 105 105 105 105 105 105 105 34 35 32 33 34 35 105 105 34 35 32 33 105 105 
40 41 42 43 40 119 120 43 40 41 42 43 40 119 120 43 40 41 38 39 36 37 38 39 105 105 38 39 36 37 105 105 
24 25 26 27 24 121 122 27 24 25 26 27 24 121 122 27 24 25 26 27 24 25 26 27 105 105 26 27 24 25 105 105 
28 29 30 31 28 123 124 31 28 29 30 31 28 123 124 31 28 29 30 31 28 29 30 31 105 105 30 31 28 29 105 105 
105 105 105 105 105 105 105 105 105 105 105 105 105 105 105 105 105 105 105 105 105 105 105 105 105 105 34 35 105 105 105 105 
40 119 120 43 40 41 42 43 105 105 105 105 40 41 42 43 40 119 120 43 40 41 42 43 40 41 38 39 40 41 105 105 
24 121 122 27 24 25 26 27 105 105 105 105 24 25 26 27 24 121 122 27 24 25 26 27 24 25 26 27 24 25 105 105 
28 123 124 31 28 29 30 31 105 105 105 105 28 29 30 31 28 119 124 31 28 29 30 31 28 29 30 31 28 29 105 105 
105 105 105 105 32 33 34 35 105 105 105 105 105 105 105 105 105 105 105 105 105 105 105 105 105 105 105 105 105 105 105 105 

8 
STONE 176 80 0
STONE 352 272 0
STONE 112 144 -1
ENEMY BOUNCINGBALL 64 96 4
ENEMY BOUNCINGBALL 192 160 3
ENEMY BOUNCINGBALL 384 288 2
ENEMY SKELETON 176 144
ENEMY SKELETON 240 16
