32 20
105 105 105 105 105 105 105 105 166 166 105 105 105 105 105 105 105 105 105 105 4 5 6 7 4 5 6 7 105 105 105 105 
105 105 105 105 105 105 105 105 166 166 105 105 105 105 105 105 105 105 105 105 8 9 10 11 8 9 10 11 105 105 105 105 
105 105 105 105 105 105 105 105 166 166 105 105 105 105 105 105 105 105 105 105 12 13 14 15 12 13 14 15 105 105 105 105 
105 105 105 105 105 105 105 105 166 166 105 105 105 105 105 105 105 105 105 105 16 17 18 19 16 17 18 19 105 105 105 105 
20 155 156 21 20 21 20 21 20 23 20 21 22 155 156 23 22 23 22 23 4 5 6 7 4 5 6 7 20 21 22 23 
8 157 158 11 8 9 10 11 8 9 10 11 8 157 158 11 8 9 10 11 8 9 10 11 8 9 10 11 8 9 10 11 
12 159 160 15 12 13 14 15 12 13 14 15 12 159 160 15 12 13 14 15 12 13 14 15 12 13 14 15 12 13 14 15 
105 105 105 105 16 17 18 19 16 17 18 19 105 105 105 105 106 106 105 105 105 105 105 105 105 105 105 105 105 105 105 105 
105 105 105 105 4 5 6 7 4 5 6 7 105 105 105 105 20 21 20 21 105 105 105 105 20 21 20 21 20 155 156 21 
105 105 105 105 8 9 10 11 8 9 10 11 105 105 105 105 8 9 10 11 105 105 105 105 8 9 10 11 8 157 158 11 
105 105 105 105 12 13 14 15 12 13 14 15 105 105 105 105 12 13 14 15 105 105 105 105 12 13 14 15 12 159 160 15 
105 105 105 105 105 105 105 105 16 17 18 19 105 105 105 105 105 105 106 106 105 105 105 105 105 105 105 105 105 105 105 105 
105 105 105 105 20 21 20 21 4 5 6 7 105 105 105 105 20 21 20 21 105 105 105 105 20 155 156 21 20 21 20 21 
105 105 105 105 8 9 10 11 8 9 10 11 105 105 105 105 8 9 10 11 105 105 105 105 8 157 158 11 8 9 10 11 
105 105 105 105 12 13 14 15 12 13 14 15 105 105 105 105 12 13 14 15 105 105 105 105 12 159 160 15 12 13 14 15 
105 105 105 105 16 17 18 19 105 105 105 105 105 105 105 105 16 17 18 19 105 105 105 105 105 105 105 105 105 105 105 105 
105 105 105 105 4 5 6 7 20 21 20 21 105 105 105 105 4 5 6 7 105 105 105 105 20 21 20 21 20 155 156 21 
105 105 105 105 8 9 10 11 8 9 10 11 105 105 105 105 8 9 10 11 105 105 105 105 8 9 10 11 8 157 158 11 
105 105 105 105 12 13 14 15 12 13 14 15 105 105 105 105 12 13 14 15 105 105 105 105 12 13 14 15 12 159 160 15 
105 105 105 105 105 105 105 105 16 17 18 19 105 105 105 105 105 105 105 105 105 105 105 105 105 105 105 105 105 105 105 105 

4 
LADDER 256 128 3 0
LADDER 288 192 7 0
STONE 416 144 0
STONE 64 144 0

FAIRY 368 80