32 20
105 105 105 105 105 105 105 105 105 105 105 105 105 105 105 105 105 105 105 105 105 105 105 105 4 5 6 7 4 5 105 105 
105 105 105 105 105 105 105 105 105 105 105 105 105 105 105 105 105 105 105 105 105 105 105 105 8 9 10 11 8 9 105 105 
105 105 105 105 105 105 105 105 105 105 105 105 105 105 105 105 105 105 105 105 105 105 105 105 12 13 14 15 12 13 105 105 
105 105 105 105 105 105 105 105 105 105 105 105 105 105 105 105 105 105 105 105 105 105 105 105 16 17 105 105 105 105 105 105 
105 105 22 23 20 21 22 23 20 21 22 23 20 21 22 23 20 21 22 23 20 21 22 23 4 5 22 23 20 21 105 105 
105 105 10 11 8 9 10 11 8 9 10 11 8 9 10 11 8 9 10 11 8 9 10 11 8 9 10 11 8 9 105 105 
105 105 14 15 12 13 14 15 12 13 14 15 12 13 14 15 12 13 14 15 12 13 14 15 12 13 14 15 12 13 105 105 
105 105 18 19 16 17 18 19 16 17 18 19 16 17 18 19 16 17 18 19 16 17 18 19 16 17 18 19 16 17 105 105 
105 105 6 7 4 5 6 7 4 5 6 7 4 5 6 7 4 5 6 7 4 5 6 7 4 5 6 7 4 5 105 105 
105 105 10 11 8 9 10 11 8 9 10 11 8 9 10 11 8 9 10 11 8 9 10 11 8 9 10 11 8 9 105 105 
105 105 14 15 12 13 14 15 12 13 14 15 12 13 14 15 12 13 14 15 12 13 14 15 12 13 14 15 12 13 105 105 
105 105 105 105 105 105 18 19 16 17 18 19 16 17 18 19 16 17 18 19 16 17 18 19 16 17 18 19 16 17 105 105 
105 105 22 23 20 21 6 7 4 5 6 7 4 5 6 7 4 5 6 7 4 5 6 7 4 5 6 7 4 5 105 105 
105 105 10 11 8 9 10 11 8 9 10 11 8 9 10 11 8 9 10 11 8 9 10 11 8 9 10 11 8 9 105 105 
105 105 14 15 12 13 14 15 12 13 14 15 12 13 14 15 12 13 14 15 12 13 14 15 12 13 14 15 12 13 105 105 
105 105 105 105 105 105 105 105 106 106 105 105 105 105 105 105 105 105 105 105 105 105 105 105 105 105 105 105 105 105 105 105 
105 105 22 23 20 21 22 23 20 21 22 23 20 21 22 23 20 155 156 23 20 21 22 23 20 21 22 23 20 21 105 105 
105 105 10 11 8 9 10 11 8 9 10 11 8 9 10 11 8 157 158 11 8 9 10 11 8 9 10 11 8 9 105 105 
105 105 14 15 12 13 14 15 12 13 14 15 12 13 14 15 12 159 160 15 12 13 14 15 12 13 14 15 12 13 105 105 
105 105 18 19 16 17 18 19 105 105 105 105 105 105 105 105 105 105 105 105 105 105 105 105 16 17 18 19 16 17 105 105 

11 
LADDER 128 256 3 0
ENEMY PORCUPINE 96 208
ENEMY PORCUPINE 320 272
ENEMY PORCUPINE 416 208
STONE 384 208 0
DOOR 448 16 1
STONE 448 16 0
ENEMY BAMBU 192 272
ENEMY BAMBU 64 144
ENEMY BAMBU 320 208
ENEMY BAMBU 192 208
