32 20
105 105 105 105 105 105 105 105 0 1 0 1 0 1 0 1 0 1 0 1 0 1 0 1 0 1 0 1 0 1 105 105 
105 105 105 105 105 105 105 105 1 0 1 0 1 0 1 0 1 0 1 0 1 0 1 0 1 0 1 0 1 0 105 105 
105 105 105 105 105 105 105 105 0 1 0 1 0 1 0 1 0 1 0 1 0 1 0 1 0 1 0 1 0 1 105 105 
105 105 105 105 105 105 105 105 105 105 105 105 105 105 105 105 1 0 1 0 105 105 106 106 105 105 105 105 105 105 105 105 
105 105 2 3 2 3 2 3 2 3 2 3 2 64 65 3 0 1 0 1 2 3 2 3 2 3 2 3 105 105 105 105 
105 105 1 0 1 101 102 0 1 0 1 0 1 66 67 0 1 0 1 0 1 0 1 0 1 0 1 0 105 105 105 105 
105 105 0 1 0 103 104 1 0 1 0 1 0 68 69 1 0 1 0 1 0 1 0 1 0 1 0 1 105 105 105 105 
105 105 105 105 105 105 105 105 1 0 1 0 105 105 105 105 105 105 105 105 105 105 105 105 1 0 1 0 105 105 105 105 
105 105 105 105 105 105 2 3 0 1 0 1 2 98 98 3 2 64 65 3 2 3 2 3 0 1 0 1 2 3 105 105 
105 105 105 105 105 105 1 0 1 0 1 0 1 100 99 0 1 66 67 0 1 101 102 0 1 0 1 0 1 0 105 105 
105 105 105 105 105 105 0 1 0 1 0 1 0 1 100 1 0 68 69 1 0 103 104 1 0 1 0 1 0 1 105 105 
105 105 105 105 105 105 1 0 105 105 105 105 105 105 105 105 106 106 105 105 105 105 105 105 105 105 105 105 105 105 105 105 
105 105 105 105 105 105 0 1 2 3 2 3 2 3 2 3 2 3 2 3 2 64 65 3 2 98 98 3 2 3 105 105 
105 105 105 105 105 105 1 0 1 0 1 0 1 0 1 0 1 0 1 0 1 66 67 0 1 100 99 0 1 0 105 105 
105 105 105 105 105 105 0 1 0 1 0 1 0 1 0 1 0 1 0 1 0 68 69 1 0 1 100 1 0 1 105 105 
105 105 105 105 105 105 105 105 1 0 1 0 1 0 1 0 1 0 1 0 105 105 105 105 105 105 105 105 105 105 105 105 
105 105 2 3 2 98 98 3 0 1 0 1 0 1 0 1 0 1 0 1 2 3 2 3 2 3 2 3 2 3 105 105 
105 105 1 0 1 100 99 0 1 0 1 0 1 0 1 0 1 0 1 0 1 0 1 0 1 101 102 0 1 0 105 105 
105 105 0 1 0 1 100 1 0 1 0 1 0 1 0 1 0 1 0 1 0 1 0 1 0 103 104 1 0 1 105 105 
105 105 105 105 105 105 105 105 1 0 1 0 1 0 1 0 105 105 105 105 105 105 105 105 105 105 105 105 105 105 105 105 

8 
LADDER 160 0 3 0
LADDER 256 192 7 0
LADDER 352 64 3 0
LADDER 384 0 3 0
STONE 256 80 -2
STONE 192 144 0
ENEMY BAT 224 64
ENEMY BAT 224 192

BLOBS
