32 20
36 37 38 39 36 37 38 39 36 37 38 39 36 37 38 39 36 37 38 39 105 105 105 105 105 105 38 39 36 37 38 39 
24 25 26 27 24 25 26 27 24 25 26 27 24 25 26 27 24 25 26 27 105 105 105 105 105 105 26 27 24 25 26 27 
28 29 30 31 28 29 30 31 28 29 30 31 28 29 30 31 28 29 30 31 105 105 105 105 105 105 30 31 28 29 30 31 
105 105 105 105 105 105 106 106 32 33 34 35 105 105 105 105 32 33 34 35 105 105 105 105 105 105 105 105 105 105 105 105 
105 105 42 43 40 41 42 43 36 37 38 39 40 41 42 43 36 37 38 39 40 41 42 43 40 119 120 43 40 41 42 43 
105 105 26 27 24 25 26 27 24 25 26 27 24 25 26 27 24 25 26 27 24 25 26 27 24 121 122 27 24 25 26 27 
105 105 30 31 28 29 30 31 28 29 30 31 28 29 30 31 28 29 30 31 28 29 30 31 28 123 124 31 28 29 30 31 
105 105 34 35 32 33 34 35 32 33 34 35 32 33 34 35 32 33 34 35 32 33 34 35 105 105 106 106 32 33 105 105 
105 105 38 39 36 37 38 39 36 37 38 39 36 37 38 39 36 37 38 39 36 37 38 39 105 105 42 43 36 37 105 105 
105 105 26 27 24 25 26 27 24 25 26 27 24 25 26 27 24 25 26 27 24 25 26 27 105 105 26 27 24 25 105 105 
105 105 30 31 28 29 30 31 28 29 30 31 28 29 30 31 28 29 30 31 28 29 30 31 105 105 30 31 28 29 105 105 
105 105 34 35 32 33 34 35 32 33 105 105 106 106 105 105 105 105 105 105 105 105 105 105 105 105 34 35 32 33 105 105 
105 105 38 39 36 37 38 39 36 37 42 43 40 41 42 43 40 41 42 43 40 119 120 43 105 105 38 39 36 37 42 43 
105 105 26 27 24 25 26 27 24 25 26 27 24 25 26 27 24 25 26 27 24 121 122 27 105 105 26 27 24 25 26 27 
105 105 30 31 28 29 30 31 28 29 30 31 28 29 30 31 28 29 30 31 28 123 124 31 105 105 30 31 28 29 30 31 
105 105 34 35 32 33 34 35 32 33 34 35 105 105 105 105 32 33 34 35 105 105 105 105 105 105 105 105 105 105 105 105 
105 105 38 39 36 37 38 39 36 37 38 39 40 41 42 43 36 37 38 39 40 41 42 43 40 41 42 43 40 41 42 43 
105 105 26 27 24 25 26 27 24 25 26 27 24 25 26 27 24 25 26 27 24 25 26 27 24 25 26 27 24 25 26 27 
105 105 30 31 28 29 30 31 28 29 30 31 28 29 30 31 28 29 30 31 28 29 30 31 28 29 30 31 28 29 30 31 
105 105 105 105 105 105 105 105 105 105 105 105 105 105 105 105 105 105 105 105 105 105 105 105 105 105 105 105 105 105 105 105 

7 
LADDER 224 0 3 0
LADDER 192 192 3 0
LADDER 96 64 15 0
LADDER 416 128 7 0
STONE 288 144 0
ENEMY BOUNCINGBALL 384 96 3
ENEMY BOUNCINGBALL 352 288 2

SLIME