32 20
105 105 105 105 0 1 0 1 0 1 0 1 0 1 0 1 0 1 0 1 0 1 0 1 0 1 0 1 0 1 0 1 
105 105 105 105 1 0 1 0 1 0 1 0 1 0 1 0 1 0 1 0 1 0 1 0 1 0 1 0 1 0 1 0 
105 105 105 105 0 1 0 1 0 1 0 1 0 1 0 1 0 1 0 1 0 1 0 1 0 1 0 1 0 1 0 1 
105 105 105 105 1 0 1 0 105 105 105 105 105 105 105 105 105 105 105 105 105 105 105 105 106 106 105 105 105 105 105 105 
105 105 105 105 0 1 0 1 2 98 98 3 2 3 2 3 2 3 2 3 2 3 2 3 2 3 2 3 2 3 105 105 
105 105 105 105 1 0 1 0 1 100 99 0 1 0 1 0 1 0 1 0 1 0 1 0 1 0 1 0 1 0 105 105 
105 105 105 105 0 1 0 1 0 1 100 1 0 1 0 1 0 1 0 1 0 1 0 1 0 1 0 1 0 1 105 105 
105 105 105 105 105 105 105 105 105 105 105 105 106 106 105 105 1 0 1 0 105 105 105 105 105 105 105 105 105 105 105 105 
105 105 105 105 2 3 2 3 2 3 2 3 2 3 2 3 0 1 0 1 2 98 98 3 2 3 2 3 2 3 105 105 
105 105 105 105 1 0 1 0 1 101 102 0 1 0 1 0 1 0 1 0 1 100 99 0 1 101 102 0 1 0 105 105 
105 105 105 105 0 1 0 1 0 103 104 1 0 1 0 1 0 1 0 1 0 1 100 1 0 103 104 0 0 1 105 105 
105 105 105 105 1 0 1 0 105 105 105 105 106 106 105 105 105 105 105 105 106 106 105 105 105 105 105 105 105 105 105 105 
105 105 105 105 0 1 0 1 2 3 2 3 2 3 2 3 2 3 2 3 2 3 2 3 2 98 98 3 2 3 105 105 
105 105 105 105 1 0 1 0 1 0 1 0 1 0 1 0 1 101 102 0 1 0 1 0 1 100 99 0 1 0 105 105 
105 105 105 105 0 1 0 1 0 1 0 1 0 1 0 1 0 103 104 1 0 1 0 1 0 1 100 1 0 1 105 105 
105 105 105 105 1 0 1 0 1 0 1 0 1 0 1 0 105 105 105 105 106 106 105 105 105 105 105 105 105 105 105 105 
105 105 105 105 0 1 0 1 0 1 0 1 0 1 0 1 2 64 65 3 2 3 2 3 2 3 2 3 2 3 105 105 
105 105 105 105 1 0 1 0 1 0 1 0 1 0 1 0 1 66 67 0 1 0 1 0 1 101 102 0 1 0 105 105 
105 105 105 105 0 1 0 1 0 1 0 1 0 1 0 1 0 68 69 1 0 1 0 1 0 103 104 1 0 1 105 105 
105 105 105 105 105 105 105 105 105 105 105 105 105 105 105 105 105 105 105 105 105 105 105 105 105 105 105 105 105 105 105 105 

11 
LADDER 192 128 3 0
LADDER 384 64 3 0
LADDER 192 192 7 0
LADDER 320 192 3 0
LADDER 320 256 3 0
WDOOR 64 256 7
ENEMY SKELETON 256 272
ENEMY SKELETON 384 208
ENEMY SKELETON 128 80
ENEMY SKELETON 256 144
ENEMY GHOST 256 16
