32 20
105 105 105 105 36 37 38 39 36 37 38 39 36 37 38 39 36 37 38 39 36 37 38 39 36 37 38 39 36 37 105 105 
105 105 105 105 24 25 26 27 24 25 26 27 24 25 26 27 24 25 26 27 24 25 26 27 24 25 26 27 24 25 105 105 
105 105 105 105 28 29 30 31 28 29 30 31 28 29 30 31 28 29 30 31 28 29 30 31 28 29 30 31 28 29 105 105 
105 105 105 105 32 33 106 106 105 105 105 105 32 33 34 35 105 105 105 105 105 105 105 105 105 105 105 105 32 33 105 105 
105 105 105 105 36 37 38 39 105 105 105 105 36 37 38 39 105 105 105 105 105 105 105 105 105 105 105 105 36 37 105 105 
105 105 105 105 24 25 26 27 105 105 105 105 24 25 26 27 105 105 105 105 105 105 105 105 105 105 105 105 24 25 105 105 
105 105 105 105 28 29 30 31 105 105 105 105 28 29 30 31 105 105 105 105 105 105 105 105 105 105 105 105 28 29 105 105 
105 105 105 105 32 33 34 35 105 105 105 105 32 33 34 35 105 105 105 105 105 105 105 105 105 105 105 105 32 33 105 105 
105 105 105 105 36 37 38 39 40 119 120 43 36 37 38 39 40 41 42 43 40 41 42 43 40 41 42 43 36 37 42 43 
105 105 105 105 24 25 26 27 24 121 122 27 24 25 26 27 24 25 26 27 24 25 26 27 24 25 26 27 24 25 26 27 
105 105 105 105 28 29 30 31 28 123 124 31 28 29 30 31 28 29 30 31 28 29 30 31 28 29 30 31 28 29 30 31 
105 105 105 105 105 105 105 105 105 105 105 105 105 105 105 105 32 33 34 35 32 33 34 35 32 33 105 105 105 105 105 105 
105 105 105 105 105 105 105 105 105 105 105 105 105 105 105 105 36 37 38 39 36 37 38 39 36 37 42 43 105 105 105 105 
105 105 105 105 105 105 105 105 105 105 105 105 105 105 105 105 24 25 26 27 24 25 26 27 24 25 26 27 105 105 105 105 
105 105 105 105 105 105 105 105 105 105 105 105 105 105 105 105 28 29 30 31 28 29 30 31 28 29 30 31 105 105 105 105 
105 105 105 105 105 105 105 105 105 105 105 105 105 105 105 105 32 33 34 35 105 105 105 105 32 33 34 35 105 105 105 105 
105 105 105 105 105 105 105 105 105 105 105 105 105 105 105 105 36 37 38 39 40 41 42 43 36 37 38 39 105 105 105 105 
105 105 105 105 105 105 105 105 105 105 105 105 105 105 105 105 24 25 26 27 24 25 26 27 24 25 26 27 105 105 105 105 
105 105 105 105 105 105 105 105 105 105 105 105 105 105 105 105 28 29 30 31 28 29 30 31 28 29 30 31 105 105 105 105 
105 105 105 105 105 105 105 105 105 105 105 105 105 105 105 105 105 105 34 35 32 33 34 35 32 33 34 35 105 105 105 105 

3 
LADDER 96 64 7 0
STONE 320 208 0
STONE 272 16 8

SLIME