32 20
105 105 105 105 105 105 105 105 0 1 0 1 0 1 0 1 0 1 0 1 0 1 0 1 0 1 0 1 0 1 105 105 
105 105 105 105 105 105 105 105 1 0 1 0 1 0 1 0 1 0 1 0 1 0 1 0 1 0 1 0 1 0 105 105 
105 105 105 105 105 105 105 105 0 1 0 1 0 1 0 1 0 1 0 1 0 1 0 1 0 1 0 1 0 1 105 105 
105 105 105 105 105 105 105 105 106 106 105 105 105 105 105 105 106 106 105 105 1 0 1 0 1 0 106 106 105 105 105 105 
105 105 105 105 105 105 105 105 2 3 2 3 2 3 2 3 2 3 2 3 0 1 0 1 0 1 2 3 2 3 105 105 
105 105 105 105 105 105 105 105 1 0 1 0 1 0 1 0 1 0 1 0 1 0 1 0 1 0 1 0 1 0 105 105 
105 105 105 105 105 105 105 105 0 1 0 1 0 1 0 1 0 1 0 1 0 1 0 1 0 1 0 1 0 1 105 105 
105 105 105 105 105 105 105 105 1 0 1 0 1 0 1 0 1 0 1 0 1 0 1 0 1 0 105 105 105 105 105 105 
2 3 2 3 2 3 105 105 0 1 0 1 0 1 0 1 0 1 0 1 0 1 0 1 0 1 2 3 2 3 105 105 
1 0 1 0 1 0 105 105 1 0 1 0 1 0 1 0 1 0 1 0 1 0 1 0 1 0 1 0 1 0 105 105 
0 1 0 1 0 1 105 105 0 1 0 1 0 1 0 1 0 1 0 1 0 1 0 1 0 1 0 1 0 1 105 105 
105 105 106 106 1 0 105 105 1 0 1 0 105 105 105 105 105 105 105 105 105 105 105 105 105 105 105 105 105 105 105 105 
105 105 0 1 0 1 105 105 0 1 0 1 2 3 2 3 2 3 2 3 2 3 2 3 2 3 2 3 2 3 105 105 
105 105 1 0 1 0 105 105 1 0 1 0 1 0 1 0 1 0 1 0 1 0 1 0 1 0 1 0 1 0 105 105 
105 105 0 1 0 1 105 105 0 1 0 1 0 1 0 1 0 1 0 1 0 1 0 1 0 1 0 1 0 1 105 105 
105 105 1 0 1 0 105 105 105 105 105 105 105 105 105 105 105 105 105 105 105 105 105 105 1 0 1 0 1 0 105 105 
105 105 0 1 0 1 2 3 2 3 2 3 2 3 2 3 2 76 77 3 2 3 2 3 0 1 0 1 0 1 105 105 
105 105 1 0 1 0 1 0 1 0 1 0 1 0 1 0 1 78 79 0 1 0 1 0 1 0 1 0 1 0 105 105 
105 105 0 1 0 1 0 1 0 1 0 1 0 1 0 1 0 80 81 1 0 1 0 1 0 1 0 1 0 1 105 105 
105 105 105 105 105 105 105 105 105 105 105 105 105 105 105 105 105 105 105 105 105 105 105 105 105 105 105 105 105 105 105 105 

21 
LADDER 32 192 7 0
LADDER 128 64 11 0
LADDER 256 64 7 0
LADDER 416 64 3 0
STONE 224 16 -2
STONE 160 272 0
STONE 336 272 0
ENEMY SPIDER 96 256
ENEMY SPIDER 256 256
ENEMY SPIDER 256 0
ENEMY SPIDER 224 192
ENEMY WORM 192 272 0
ENEMY WORM 304 272 0
ENEMY WORM 384 272 0
ENEMY WORM 352 208 0
ENEMY WORM 256 208 0
ENEMY WORM 224 144 0
ENEMY WORM 128 16 0
ENEMY WORM 448 16 0
ENEMY WORM 448 80 0
ENEMY WORM 448 144 0
