32 20
4 5 6 7 4 5 6 7 4 5 6 7 4 5 6 7 4 5 6 7 4 5 6 7 4 5 6 7 4 5 105 105 
8 9 10 11 8 9 10 11 8 9 10 11 8 9 10 11 8 9 10 11 8 9 10 11 8 9 10 11 8 9 105 105 
12 13 14 15 12 13 14 15 12 13 14 15 12 13 14 15 12 13 14 15 12 13 14 15 12 13 14 15 12 13 105 105 
16 17 18 19 105 105 105 105 105 105 105 105 105 105 105 105 16 17 18 19 105 105 105 105 105 105 105 105 105 105 105 105 
4 5 6 7 20 21 22 23 20 155 156 23 20 21 105 105 4 5 6 7 105 105 22 23 20 155 156 23 20 21 105 105 
8 9 10 11 8 9 10 11 8 157 158 11 8 9 105 105 8 9 10 11 105 105 10 11 8 157 158 11 8 9 105 105 
12 13 14 15 12 13 14 15 12 159 160 15 12 13 105 105 12 13 14 15 105 105 14 15 12 159 160 15 12 13 105 105 
16 17 18 19 16 17 105 105 105 105 105 105 106 106 105 105 105 105 18 19 105 105 18 19 105 105 105 105 16 17 105 105 
4 5 6 7 4 5 105 105 20 21 22 23 20 21 22 23 20 21 6 7 20 21 6 7 20 21 105 105 4 5 105 105 
8 9 10 11 8 9 105 105 8 9 10 11 8 9 10 11 8 9 10 11 8 9 10 11 8 9 105 105 8 9 105 105 
12 13 14 15 12 13 105 105 12 13 14 15 12 13 14 15 12 13 14 15 12 13 14 15 12 13 105 105 12 13 105 105 
105 105 105 105 105 105 105 105 16 17 105 105 105 105 105 105 105 105 105 105 106 106 105 105 16 17 105 105 105 105 105 105 
105 105 22 23 20 155 156 23 4 5 22 23 20 21 105 105 20 21 22 23 20 21 22 23 4 5 22 23 20 21 105 105 
105 105 10 11 8 157 158 11 8 9 10 11 8 9 105 105 8 9 10 11 8 9 10 11 8 9 10 11 8 9 105 105 
105 105 14 15 12 159 160 15 12 13 14 15 12 13 105 105 12 13 14 15 12 13 14 15 12 13 14 15 12 13 105 105 
105 105 18 19 105 105 106 106 105 105 105 105 105 105 105 105 105 105 106 106 105 105 105 105 106 106 105 105 16 17 105 105 
105 105 6 7 20 21 22 23 20 21 22 23 20 21 22 23 20 21 22 23 20 21 22 23 20 21 22 23 4 5 105 105 
105 105 10 11 8 9 10 11 8 9 10 11 8 9 10 11 8 9 10 11 8 9 10 11 8 9 10 11 8 9 105 105 
105 105 14 15 12 13 14 15 12 13 14 15 12 13 14 15 12 13 14 15 12 13 14 15 12 13 14 15 12 13 105 105 
105 105 105 105 105 105 105 105 105 105 105 105 105 105 105 105 105 105 105 105 105 105 105 105 105 105 105 105 105 105 105 105 

14 
LADDER 96 256 3 0
LADDER 192 128 3 0
LADDER 320 192 3 0
LADDER 288 256 3 0
LADDER 384 256 3 0
WDOOR 192 256 8
ENEMY PORCUPINE 128 16
ENEMY PORCUPINE 160 144
ENEMY PORCUPINE 128 208
ENEMY PORCUPINE 128 272
ENEMY PORCUPINE 384 272
ENEMY PORCUPINE 384 208
ENEMY PORCUPINE 352 144
ENEMY PORCUPINE 384 16
