32 20
36 37 38 39 36 37 38 39 36 37 38 39 105 105 105 105 105 105 105 105 36 37 38 39 36 37 38 39 36 37 38 39 
24 25 26 27 24 25 26 27 24 25 26 27 105 105 105 105 105 105 105 105 24 25 26 27 24 25 26 27 24 25 26 27 
28 29 30 31 28 29 30 31 28 29 30 31 105 105 105 105 105 105 105 105 28 29 30 31 28 29 30 31 28 29 30 31 
105 105 105 105 106 106 105 105 32 33 34 35 105 105 105 105 105 105 105 105 32 33 34 35 32 33 106 106 105 105 105 105 
40 119 120 43 40 41 42 43 36 37 38 39 105 105 105 105 105 105 105 105 36 37 38 39 36 37 42 43 105 105 105 105 
24 121 122 27 24 25 26 27 24 25 26 27 105 105 105 105 105 105 105 105 24 25 26 27 24 25 26 27 105 105 105 105 
28 123 124 31 28 29 30 31 28 29 30 31 105 105 105 105 105 105 105 105 28 29 30 31 28 29 30 31 105 105 105 105 
105 105 105 105 105 105 105 105 106 106 105 105 105 105 105 105 105 105 105 105 32 33 34 35 32 33 34 35 105 105 105 105 
105 105 105 105 40 41 42 43 40 41 42 43 105 105 105 105 105 105 105 105 36 37 38 39 36 37 38 39 105 105 105 105 
105 105 105 105 24 25 26 27 24 25 26 27 105 105 105 105 105 105 105 105 24 25 26 27 24 25 26 27 105 105 105 105 
105 105 105 105 28 29 30 31 28 29 30 31 105 105 105 105 105 105 105 105 28 29 30 31 28 29 30 31 105 105 105 105 
105 105 105 105 32 33 105 105 105 105 106 106 105 105 105 105 105 105 105 105 32 33 34 35 32 33 34 35 105 105 105 105 
105 105 105 105 36 37 42 43 40 41 42 43 105 105 105 105 105 105 105 105 36 37 38 39 36 37 38 39 105 105 105 105 
105 105 105 105 24 25 26 27 24 25 26 27 105 105 105 105 105 105 105 105 24 25 26 27 24 25 26 27 105 105 105 105 
105 105 105 105 28 29 30 31 28 29 30 31 105 105 105 105 105 105 105 105 28 29 30 31 28 29 30 31 105 105 105 105 
105 105 105 105 32 33 34 35 32 33 34 35 105 105 105 105 105 105 105 105 32 33 34 35 32 33 34 35 105 105 105 105 
105 105 105 105 36 37 38 39 36 37 38 39 105 105 105 105 105 105 105 105 36 37 38 39 36 37 38 39 105 105 105 105 
105 105 105 105 24 25 26 27 24 25 26 27 105 105 105 105 105 105 105 105 24 25 26 27 24 25 26 27 105 105 105 105 
105 105 105 105 28 29 30 31 28 29 30 31 105 105 105 105 105 105 105 105 28 29 30 31 28 29 30 31 105 105 105 105 
105 105 105 105 105 105 105 105 105 105 105 105 105 105 105 105 105 105 105 105 105 105 105 105 105 105 105 105 105 105 105 105 

9 
LADDER 64 64 3 0
LADDER 96 0 3 0
LADDER 128 128 3 0
LADDER 160 192 7 0
LADDER 416 64 15 0
STONE 320 272 0
STONE 64 272 0
ENEMY KNIGHT 128 272
ENEMY KNIGHT 160 80
