32 20

000 001 000 001 000 001 000 001 000 001 000 001 000 001 000 001 000 001 000 001 000 001 000 001 000 001 000 001 000 001 000 001 
001 000 001 000 001 000 001 000 001 000 001 000 001 000 001 000 001 000 001 000 001 000 001 000 001 000 001 000 001 000 001 000 
000 001 000 001 000 001 000 001 000 001 000 001 000 001 000 001 000 001 000 001 000 001 000 001 000 001 000 001 000 001 000 001 
001 000 001 000 001 000 001 000 001 000 001 000 001 000 001 000 001 000 001 000 001 000 001 000 001 000 001 000 001 000 001 000 
000 001 000 001 000 001 000 001 000 001 000 001 000 001 000 001 000 001 000 001 000 001 000 001 000 001 000 001 000 001 000 001 
001 000 001 000 001 000 001 000 001 000 001 000 001 000 001 000 001 000 001 000 001 000 001 000 001 000 001 000 001 000 001 000 
000 001 000 001 000 001 000 001 000 001 000 001 000 001 000 001 000 001 000 001 000 001 000 001 000 001 000 001 000 001 000 001 
001 000 001 000 001 000 001 000 001 000 001 000 001 000 001 000 001 000 001 000 001 000 001 000 001 000 001 000 001 000 001 000 
000 001 000 001 000 001 000 001 000 001 000 001 000 001 000 001 000 001 000 001 000 001 000 001 000 001 000 001 000 001 000 001 
001 000 001 000 001 000 001 000 001 000 001 000 001 000 001 000 001 000 001 000 001 000 001 000 001 000 001 000 001 000 001 000 
000 001 000 001 000 001 000 001 000 001 000 001 000 001 000 001 000 001 000 001 000 001 000 001 000 001 000 001 000 001 000 001 
105 105 105 105 105 105 105 105 105 105 105 105 105 105 106 106 105 105 105 105 105 105 105 105 105 105 105 105 105 105 105 105 
105 105 105 105 105 105 105 105 105 105 105 105 105 105 000 001 105 105 105 105 105 105 105 105 105 105 105 105 105 105 105 105 
105 105 105 105 105 105 105 105 105 105 105 105 105 105 001 000 105 105 105 105 105 105 105 105 105 105 105 105 105 105 105 105 
105 105 105 105 105 105 105 105 105 105 105 105 105 105 000 001 105 105 105 105 105 105 105 105 105 105 105 105 105 105 105 105 
105 105 105 105 105 105 105 105 105 105 105 105 105 105 001 000 105 105 105 105 105 105 105 105 105 105 105 105 105 105 105 105 
105 105 105 105 105 105 105 105 105 105 105 105 105 105 000 001 105 105 105 105 105 105 105 105 105 105 105 105 105 105 105 105 
105 105 105 105 105 105 105 105 105 105 105 105 105 105 001 000 105 105 105 105 105 105 105 105 105 105 105 105 105 105 105 105 
105 105 105 105 105 105 105 105 105 105 105 105 105 105 000 001 105 105 105 105 105 105 105 105 105 105 105 105 105 105 105 105 
105 105 105 105 105 105 105 105 105 105 105 105 105 105 001 000 105 105 105 105 105 105 105 105 105 105 105 105 105 105 105 105 

2
LADDER 224 0 11 0
LADDER 224 192 9 0