32 20
105 105 105 105 105 105 105 105 105 105 105 105 105 105 105 105 48 49 50 51 48 49 50 51 105 105 105 105 105 105 105 105 
105 105 105 105 105 105 105 105 105 105 105 105 105 105 105 105 52 53 54 55 52 53 54 55 105 105 105 105 105 105 105 105 
105 105 105 105 105 105 105 105 105 105 105 105 105 105 105 105 56 57 58 59 56 57 58 59 105 105 105 105 105 105 105 105 
105 105 105 105 105 105 105 105 105 105 105 105 105 105 105 105 105 105 105 105 106 106 105 105 105 105 105 105 105 105 105 105 
105 105 105 105 60 70 71 63 60 61 62 63 60 70 71 63 60 61 62 63 60 61 62 63 60 61 62 63 105 105 105 105 
105 105 105 105 52 72 73 55 52 53 54 55 52 72 73 55 52 53 54 55 52 53 54 55 52 53 54 55 105 105 105 105 
105 105 105 105 56 74 75 59 56 57 58 59 56 74 75 59 56 57 58 59 56 57 58 59 56 57 58 59 105 105 105 105 
105 105 105 105 105 105 105 105 106 106 105 105 105 105 105 105 105 105 105 105 105 105 105 105 44 45 46 47 105 105 105 105 
105 105 105 105 60 61 62 63 60 61 62 63 60 61 62 63 60 61 62 63 60 70 71 63 48 49 50 51 105 105 105 105 
105 105 105 105 52 53 54 55 52 53 54 55 52 53 54 55 52 53 54 55 52 72 73 55 52 53 54 55 105 105 105 105 
105 105 105 105 56 57 58 59 56 57 58 59 56 57 58 59 56 57 58 59 56 74 75 59 56 57 58 59 105 105 105 105 
105 105 105 105 105 105 105 105 105 105 105 105 105 105 105 105 44 45 46 47 106 106 105 105 105 105 105 105 105 105 105 105 
105 105 105 105 105 105 105 105 105 105 105 105 105 105 105 105 48 49 50 51 60 61 62 63 60 70 71 63 105 105 105 105 
105 105 105 105 105 105 105 105 105 105 105 105 105 105 105 105 52 53 54 55 52 53 54 55 52 72 73 55 105 105 105 105 
105 105 105 105 105 105 105 105 105 105 105 105 105 105 105 105 56 57 58 59 56 57 58 59 56 74 75 59 105 105 105 105 
105 105 105 105 105 105 105 105 105 105 105 105 105 105 105 105 44 45 46 47 44 45 46 47 105 105 105 105 105 105 105 105 
105 105 105 105 60 70 71 63 60 61 62 63 60 70 71 63 48 49 50 51 48 49 50 51 105 105 105 105 105 105 105 105 
105 105 105 105 52 72 73 55 52 53 54 55 52 72 73 55 52 53 54 55 52 53 54 55 105 105 105 105 105 105 105 105 
105 105 105 105 56 74 75 59 56 57 58 59 56 74 75 59 56 57 58 59 56 57 58 59 105 105 105 105 105 105 105 105 
105 105 105 105 105 105 105 105 105 105 105 105 105 105 105 105 105 105 105 105 105 105 105 105 105 105 105 105 105 105 105 105 

11 
LADDER 288 0 3 0
LADDER 320 64 3 0
LADDER 320 192 7 0
LADDER 128 128 3 0
DOOR 144 272 1
STONE 144 272 0
STONE 176 80 0
STONE 368 144 0
ENEMY SKELETON 256 80
ENEMY SKELETON 224 144
ENEMY SKELETON 256 272
