32 20
105 105 105 105 105 105 105 105 105 105 105 105 105 105 105 105 105 105 105 105 105 105 105 105 105 105 105 105 105 105 105 105 
105 105 105 105 105 105 105 105 105 105 105 105 105 105 105 105 105 105 105 105 105 105 105 105 105 105 105 105 105 105 105 105 
105 105 105 105 105 105 105 105 105 105 105 105 105 105 105 105 105 105 105 105 105 105 105 105 105 105 105 105 105 105 105 105 
105 105 105 105 105 105 105 105 105 105 105 105 105 105 105 105 105 105 105 105 105 105 105 105 105 105 105 105 105 105 105 105 
40 119 120 43 40 41 42 43 40 41 42 43 40 41 42 43 40 41 42 43 40 119 120 43 40 41 42 43 40 119 120 43 
24 121 122 27 24 25 26 27 24 25 26 27 24 25 26 27 24 25 26 27 24 121 122 27 24 25 26 27 24 121 122 27 
28 123 124 31 28 29 30 31 28 29 30 31 28 29 30 31 28 29 30 31 28 123 124 31 28 29 30 31 28 123 124 31 
105 105 105 105 32 33 34 35 32 33 34 35 32 33 105 105 32 33 34 35 105 105 105 105 32 33 34 35 105 105 105 105 
40 41 42 43 36 37 38 39 36 37 38 39 36 37 42 43 36 37 38 39 40 41 42 43 36 37 38 39 40 41 42 43 
24 25 26 27 24 25 26 27 24 25 26 27 24 25 26 27 24 25 26 27 24 25 26 27 24 25 26 27 24 25 26 27 
28 29 30 31 28 29 30 31 28 29 30 31 28 29 30 31 28 29 30 31 28 29 30 31 28 29 30 31 28 29 30 31 
32 33 34 35 32 33 34 35 105 105 105 105 32 33 34 35 32 33 34 35 32 33 34 35 32 33 34 35 32 33 34 35 
142 142 142 142 142 142 142 142 142 142 142 142 142 142 142 142 142 142 142 142 142 142 142 142 142 142 142 142 142 142 142 142 
141 141 141 141 141 141 141 141 141 141 141 141 141 141 141 141 141 141 141 141 141 141 141 141 141 141 141 141 141 141 141 141 
141 141 141 141 141 141 141 141 141 141 141 141 141 141 141 141 141 141 141 141 141 141 141 141 141 141 141 141 141 141 141 141 
141 141 141 141 141 141 141 141 141 141 141 141 105 105 105 105 141 141 141 141 141 141 141 141 141 141 141 141 141 141 141 141 
141 141 141 141 141 141 141 141 141 141 141 141 141 141 141 141 141 141 141 141 141 141 141 141 141 141 141 141 141 141 141 141 
141 141 141 141 141 141 141 141 141 141 141 141 141 141 141 141 141 141 141 141 141 141 141 141 141 141 141 141 141 141 141 141 
141 141 141 141 141 141 141 141 141 141 141 141 141 141 141 141 141 141 141 141 141 141 141 141 141 141 141 141 141 141 141 141 
105 105 105 105 105 105 105 105 105 105 105 105 105 105 105 105 105 105 105 105 105 105 105 105 105 105 105 105 105 105 105 105 

0 

WATERMONSTER