32 20
36 37 38 39 36 37 38 39 36 37 38 39 36 37 38 39 36 37 38 39 36 37 38 39 36 37 38 39 36 37 38 39 
24 25 26 27 24 25 26 27 24 25 26 27 24 25 26 27 24 25 26 27 24 25 26 27 24 25 26 27 24 25 26 27 
28 29 30 31 28 29 30 31 28 29 30 31 28 29 30 31 28 29 30 31 28 29 30 31 28 29 30 31 28 29 30 31 
105 105 34 35 32 33 105 105 105 105 105 105 105 105 105 105 105 105 105 105 105 105 105 105 105 105 105 105 105 105 105 105 
105 105 38 39 36 37 42 43 105 105 105 105 105 105 105 105 40 119 120 43 40 41 42 43 40 41 42 43 40 41 105 105 
105 105 26 27 24 25 26 27 105 105 105 105 105 105 105 105 24 121 122 27 24 25 26 27 24 25 26 27 24 25 105 105 
105 105 30 31 28 29 30 31 105 105 105 105 105 105 105 105 28 123 124 31 28 29 30 31 28 29 30 31 28 29 105 105 
105 105 105 105 105 105 34 35 105 105 105 105 105 105 105 105 105 105 105 105 105 105 105 105 32 33 34 35 32 33 105 105 
105 105 105 105 105 105 38 39 40 119 120 43 40 41 105 105 40 41 42 43 40 119 120 43 36 37 38 39 36 37 105 105 
105 105 105 105 105 105 26 27 24 121 122 27 24 25 105 105 24 25 26 27 24 121 122 27 24 25 26 27 24 25 105 105 
105 105 105 105 105 105 30 31 28 123 124 31 28 29 105 105 28 29 30 31 28 123 124 31 28 29 30 31 28 29 105 105 
105 105 105 105 105 105 105 105 105 105 105 105 32 33 105 105 105 105 105 105 105 105 105 105 32 33 34 35 105 105 105 105 
105 105 105 105 105 105 105 105 105 105 105 105 36 37 42 43 40 41 42 43 40 41 42 43 36 37 38 39 40 41 105 105 
105 105 105 105 105 105 105 105 105 105 105 105 24 25 26 27 24 25 26 27 24 25 26 27 24 25 26 27 24 25 105 105 
105 105 105 105 105 105 105 105 105 105 105 105 28 29 30 31 28 29 30 31 28 29 30 31 28 29 30 31 28 29 105 105 
105 105 105 105 105 105 105 105 105 105 105 105 105 105 105 105 32 33 34 35 32 33 34 35 105 105 105 105 105 105 105 105 
40 119 120 43 40 41 42 43 40 41 42 43 40 119 120 43 36 37 38 39 36 37 38 39 40 119 120 39 40 41 42 43 
24 121 122 27 24 25 26 27 24 25 26 27 24 121 122 27 24 25 26 27 24 25 26 27 24 121 122 27 24 25 26 27 
28 123 124 31 28 29 30 31 28 29 30 31 28 123 124 31 28 29 30 31 28 29 30 31 28 123 124 31 28 29 30 31 
105 105 105 105 105 105 105 105 105 105 105 105 105 105 105 105 105 105 105 105 105 105 105 105 105 105 105 105 105 105 105 105 

9 
STONE 448 144 -3
STONE 144 16 0
STONE 112 272 0
ENEMY BOUNCINGBALL 96 32 2
ENEMY BOUNCINGBALL 224 32 3
ENEMY BOUNCINGBALL 192 288 4
ENEMY BAT 96 64
ENEMY BAT 320 192
ENEMY BAT 448 64
