32 20
105 105 50 51 48 49 50 51 48 49 50 51 48 49 50 51 48 49 50 51 48 49 50 51 48 49 50 51 48 49 105 105 
105 105 54 55 52 53 54 55 52 53 54 55 52 53 54 55 52 53 54 55 52 53 54 55 52 53 54 55 52 53 105 105 
105 105 58 59 56 57 58 59 56 57 58 59 56 57 58 59 56 57 58 59 56 57 58 59 56 57 58 59 56 57 105 105 
105 105 105 105 105 105 105 105 106 106 105 105 105 105 105 105 44 45 46 47 105 105 105 105 106 106 105 105 105 105 105 105 
105 105 62 63 60 61 62 63 60 61 62 63 60 61 62 63 48 49 50 51 60 61 62 63 60 61 62 63 60 61 105 105 
105 105 54 55 52 53 54 55 52 53 54 55 52 53 54 55 52 53 54 55 52 53 54 55 52 53 54 55 52 53 105 105 
105 105 58 59 56 57 58 59 56 57 58 59 56 57 58 59 56 57 58 59 56 57 58 59 56 57 58 59 56 57 105 105 
105 105 46 47 44 45 105 105 105 105 105 105 105 105 106 106 105 105 46 47 105 105 105 105 105 105 105 105 105 105 105 105 
105 105 50 51 48 49 62 63 60 61 62 63 60 61 62 63 60 61 50 51 60 61 62 63 60 61 62 63 60 61 62 63 
105 105 54 55 52 53 54 55 52 53 54 55 52 53 54 55 52 53 54 55 52 53 54 55 52 53 54 55 52 53 54 55 
105 105 58 59 56 57 58 59 56 57 58 59 56 57 58 59 56 57 58 59 56 57 58 59 56 57 58 59 56 57 58 59 
105 105 105 105 105 105 105 105 44 45 46 47 105 105 105 105 105 105 105 105 44 45 46 47 44 45 46 47 44 45 105 105 
105 105 62 63 60 61 62 63 48 49 50 51 60 70 71 63 60 61 62 63 48 49 50 51 48 49 50 51 48 49 105 105 
105 105 54 55 52 53 54 55 52 53 54 55 52 72 73 55 52 53 54 55 52 53 54 55 52 53 54 55 52 53 105 105 
105 105 58 59 56 57 58 59 56 57 58 59 56 74 75 59 56 57 58 59 56 57 58 59 56 57 58 59 56 57 105 105 
105 105 105 105 105 105 105 105 105 105 105 105 105 105 105 105 44 45 46 47 44 45 46 47 44 45 46 47 44 45 105 105 
105 105 62 63 70 71 62 63 60 61 62 63 60 61 62 63 48 49 50 51 48 49 50 51 48 49 50 51 48 49 105 105 
105 105 54 55 72 73 54 55 52 53 54 55 52 53 54 55 52 53 54 55 52 53 54 55 52 53 54 55 52 53 105 105 
105 105 58 59 74 75 58 59 56 57 58 59 56 57 58 59 56 57 58 59 56 57 58 59 56 57 58 59 56 57 105 105 
105 105 105 105 105 105 105 105 105 105 105 105 44 45 46 47 105 105 105 105 105 105 105 105 105 105 105 105 105 105 105 105 

10 
STONE 64 144 0
STONE 192 80 0
STONE 320 16 0
LADDER 128 64 3 0
LADDER 384 64 3 0
LADDER 224 128 3 0
ENEMY KNIGHT 128 16
ENEMY KNIGHT 384 80
ENEMY KNIGHT 192 208
ENEMY KNIGHT 352 272
