32 20
36 37 38 39 36 37 38 39 36 37 38 39 36 37 38 39 36 37 38 39 36 37 38 39 36 37 38 39 36 37 105 105 
24 25 26 27 24 25 26 27 24 25 26 27 24 25 26 27 24 25 26 27 24 25 26 27 24 25 26 27 24 25 105 105 
28 29 30 31 28 29 30 31 28 29 30 31 28 29 30 31 28 29 30 31 28 29 30 31 28 29 30 31 28 29 105 105 
105 105 105 105 105 105 105 105 105 105 105 105 105 105 105 105 106 106 105 105 105 105 105 105 105 105 105 105 105 105 105 105 
40 41 42 43 40 41 42 43 40 41 42 43 40 119 120 43 40 41 42 43 40 119 120 43 105 105 105 105 105 105 105 105 
24 25 26 27 24 25 26 27 24 25 26 27 24 121 122 27 24 25 26 27 24 121 122 27 105 105 105 105 105 105 105 105 
28 29 30 31 28 29 30 31 28 29 30 31 28 123 124 31 28 29 30 31 28 123 124 31 105 105 105 105 105 105 105 105 
105 105 34 35 32 33 105 105 105 105 34 35 105 105 105 105 105 105 105 105 106 106 105 105 105 105 105 105 105 105 105 105 
105 105 38 39 36 37 105 105 105 105 38 39 40 41 42 43 40 119 120 43 40 41 42 43 105 105 105 105 105 105 105 105 
105 105 26 27 24 25 105 105 105 105 26 27 24 25 26 27 24 121 122 27 24 25 26 27 105 105 105 105 105 105 105 105 
105 105 30 31 28 29 105 105 105 105 30 31 28 29 30 31 28 123 124 31 28 29 30 31 105 105 105 105 105 105 105 105 
105 105 105 105 32 33 105 105 105 105 34 35 105 105 105 105 105 105 105 105 106 106 105 105 105 105 105 105 105 105 105 105 
40 41 42 43 36 37 105 105 105 105 38 39 40 41 42 43 40 41 42 43 40 41 42 43 40 41 42 43 40 41 105 105 
24 25 26 27 24 25 105 105 105 105 26 27 24 25 26 27 24 25 26 27 24 25 26 27 24 25 26 27 24 25 105 105 
28 29 30 31 28 29 105 105 105 105 30 31 28 29 30 31 28 29 30 31 28 29 30 31 28 29 30 31 28 29 105 105 
105 105 105 105 105 105 105 105 105 105 105 105 105 105 105 105 105 105 34 35 32 33 34 35 32 33 34 35 32 33 105 105 
40 119 120 43 40 41 42 43 40 41 42 43 40 119 120 43 40 41 38 39 36 37 38 39 36 37 38 39 36 37 105 105 
24 121 122 27 24 25 26 27 24 25 26 27 24 121 122 27 24 25 26 27 24 25 26 27 24 25 26 27 24 25 105 105 
28 123 124 31 28 29 30 31 28 29 30 31 28 123 124 31 28 29 30 31 28 29 30 31 28 29 30 31 28 29 105 105 
105 105 105 105 32 33 34 35 105 105 105 105 105 105 105 105 105 105 105 105 105 105 105 105 32 33 34 35 32 33 105 105 

10 
LADDER 320 128 3 0
LADDER 320 192 7 0
LADDER 256 64 3 0
STONE 192 16 24
STONE 224 144 0
STONE 160 272 0
ENEMY BOUNCINGBALL 128 288 4
ENEMY BOUNCINGBALL 288 160 3
ENEMY BOUNCINGBALL 224 32 3
ENEMY BOUNCINGBALL 128 32 2
