32 20
105 105 105 105 105 105 105 105 105 105 105 105 105 105 105 105 105 105 105 105 105 105 105 105 105 105 105 105 105 105 105 105 
105 105 105 105 105 105 105 105 105 105 105 105 105 105 105 105 105 105 105 105 105 105 105 105 105 105 105 105 105 105 105 105 
105 105 105 105 105 105 105 105 105 105 105 105 105 105 105 105 105 105 105 105 105 105 105 105 105 105 105 105 105 105 105 105 
105 105 105 105 105 105 105 105 105 105 105 105 105 105 105 105 105 105 105 105 105 105 105 105 105 105 105 105 105 105 105 105 
105 105 105 105 105 105 105 105 105 105 105 105 105 105 105 105 105 105 105 105 105 105 105 105 105 105 105 105 105 105 105 105 
105 105 105 105 105 105 105 105 105 105 105 105 105 105 105 105 105 105 105 105 105 105 105 105 105 105 105 105 105 105 105 105 
105 105 105 105 105 105 105 105 105 105 105 105 105 105 105 105 105 105 105 105 105 105 105 105 105 105 105 105 105 105 105 105 
105 105 105 105 105 105 105 105 105 105 105 105 105 105 105 105 105 105 105 105 105 105 105 105 105 105 105 105 105 105 105 105 
105 105 105 105 40 119 120 43 40 41 42 43 40 41 42 43 40 119 120 43 40 41 42 43 40 119 120 43 105 105 105 105 
105 105 105 105 24 121 122 27 24 25 26 27 24 25 26 27 24 121 122 27 24 25 26 27 24 121 122 27 105 105 105 105 
105 105 105 105 28 123 124 31 28 29 30 31 28 29 30 31 28 123 124 31 28 29 30 31 28 123 124 31 105 105 105 105 
105 105 105 105 105 105 105 105 105 105 105 105 32 33 34 35 105 105 105 105 32 33 105 105 105 105 105 105 105 105 105 105 
105 105 105 105 40 41 42 43 40 119 120 43 36 37 38 39 40 41 42 43 36 37 42 43 40 41 42 43 105 105 105 105 
105 105 105 105 24 25 26 27 24 121 122 27 24 25 26 27 24 25 26 27 24 25 26 27 24 25 26 27 105 105 105 105 
105 105 105 105 28 29 30 31 28 123 124 31 28 29 30 31 28 29 30 31 28 29 30 31 28 29 30 31 105 105 105 105 
105 105 105 105 32 33 34 35 105 105 105 105 32 33 34 35 106 106 105 105 105 105 105 105 105 105 105 105 105 105 105 105 
105 105 105 105 36 37 38 39 40 41 42 43 36 37 38 39 40 41 42 43 40 119 120 43 40 41 42 43 105 105 105 105 
105 105 105 105 24 25 26 27 24 25 26 27 24 25 26 27 24 25 26 27 24 121 122 27 24 25 26 27 105 105 105 105 
105 105 105 105 28 29 30 31 28 29 30 31 28 29 30 31 28 29 30 31 28 123 124 31 28 29 30 31 105 105 105 105 
105 105 105 105 105 105 105 105 32 33 105 105 105 105 34 35 32 33 34 35 105 105 105 105 105 105 105 105 105 105 105 105 

9 
LADDER 256 256 5 0
STONE 128 208 0
STONE 288 144 18
STONE 384 272 0
ENEMY BOUNCINGBALL 160 224 1
ENEMY BOUNCINGBALL 352 288 1
ENEMY SKELETON 96 144
ENEMY SKELETON 384 144
ENEMY SKELETON 384 208
