32 20
105 105 105 105 36 37 38 39 36 37 38 39 36 37 38 39 36 37 38 39 36 37 38 39 105 105 38 39 36 37 105 105 
105 105 105 105 24 25 26 27 24 25 26 27 24 25 26 27 24 25 26 27 24 25 26 27 105 105 26 27 24 25 105 105 
105 105 105 105 28 29 30 31 28 29 30 31 28 29 30 31 28 29 30 31 28 29 30 31 105 105 30 31 28 29 105 105 
105 105 105 105 32 33 34 35 105 105 105 105 105 105 105 105 105 105 105 105 105 105 105 105 105 105 34 35 32 33 105 105 
40 41 42 43 36 37 38 39 40 41 42 43 40 119 120 43 40 41 42 43 40 119 120 43 40 41 38 39 36 37 105 105 
24 25 26 27 24 25 26 27 24 25 26 27 24 121 122 27 24 25 26 27 24 121 122 27 24 25 26 27 24 25 105 105 
28 29 30 31 28 29 30 31 28 29 30 31 28 123 124 31 28 29 30 31 28 123 124 31 28 29 30 31 28 29 105 105 
32 33 34 35 105 105 105 105 105 105 105 105 105 105 105 105 105 105 105 105 105 105 105 105 105 105 105 105 105 105 105 105 
36 37 38 39 40 119 120 43 40 41 42 43 40 41 42 43 40 119 120 43 40 41 42 43 40 41 42 43 105 105 105 105 
24 25 26 27 24 121 122 27 24 25 26 27 24 25 26 27 24 121 122 27 24 25 26 27 24 25 26 27 105 105 105 105 
28 29 30 31 28 123 124 31 28 29 30 31 28 29 30 31 28 123 124 31 28 29 30 31 28 29 30 31 105 105 105 105 
105 105 105 105 105 105 105 105 32 33 34 35 105 105 105 105 105 105 105 105 32 33 34 35 32 33 34 35 105 105 105 105 
105 105 105 105 105 105 105 105 36 37 38 39 40 41 42 43 105 105 105 105 36 37 38 39 36 37 38 39 105 105 105 105 
105 105 105 105 105 105 105 105 24 25 26 27 24 25 26 27 105 105 105 105 24 25 26 27 24 25 26 27 105 105 105 105 
105 105 105 105 105 105 105 105 28 29 30 31 28 29 30 31 105 105 105 105 28 29 30 31 28 29 30 31 105 105 105 105 
105 105 105 105 105 105 105 105 105 105 105 105 105 105 34 35 105 105 105 105 32 33 34 35 32 33 34 35 105 105 105 105 
105 105 105 105 105 105 105 105 40 119 120 43 40 41 38 39 105 105 105 105 36 37 38 39 36 37 38 39 105 105 105 105 
105 105 105 105 105 105 105 105 24 121 122 27 24 25 26 27 105 105 105 105 24 25 26 27 24 25 26 27 105 105 105 105 
105 105 105 105 105 105 105 105 28 123 124 31 28 29 30 31 105 105 105 105 28 29 30 31 28 29 30 31 105 105 105 105 
105 105 105 105 105 105 105 105 105 105 105 105 105 105 105 105 105 105 105 105 32 33 34 35 32 33 34 35 105 105 105 105 

13 
LADDER 320 0 3 0
STONE 224 16 0
STONE 240 80 0
STONE 224 272 -1
ENEMY BAT 192 256
ENEMY BAT 384 128
ENEMY BAT 256 64
ENEMY BOUNCINGBALL 256 32 2
ENEMY BOUNCINGBALL 352 96 3
ENEMY BOUNCINGBALL 160 96 3
ENEMY BOUNCINGBALL 160 32 4
ENEMY BOUNCINGBALL 160 224 3
ENEMY BAT 96 128
