32 20
105 105 105 105 36 37 38 39 36 37 38 39 36 37 38 39 36 37 38 39 36 37 38 39 36 37 38 39 105 105 105 105 
105 105 105 105 24 25 26 27 24 25 26 27 24 25 26 27 24 25 26 27 24 25 26 27 24 25 26 27 105 105 105 105 
105 105 105 105 28 29 30 31 28 29 30 31 28 29 30 31 28 29 30 31 28 29 30 31 28 29 30 31 105 105 105 105 
105 105 105 105 105 105 105 105 105 105 105 105 105 105 105 105 106 106 105 105 105 105 105 105 32 33 34 35 105 105 105 105 
105 105 105 105 40 41 42 43 40 119 120 43 40 41 42 43 40 41 42 43 40 119 120 43 36 37 38 39 105 105 105 105 
105 105 105 105 24 25 26 27 24 121 122 27 24 25 26 27 24 25 26 27 24 121 122 27 24 25 26 27 105 105 105 105 
105 105 105 105 28 29 30 31 28 123 124 31 28 29 30 31 28 29 30 31 28 123 124 31 28 29 30 31 105 105 105 105 
105 105 105 105 105 105 105 105 106 106 105 105 105 105 34 35 32 33 34 35 105 105 105 105 105 105 105 105 105 105 105 105 
105 105 105 105 40 41 42 43 40 41 42 43 40 41 38 39 36 37 38 39 40 41 42 43 40 119 120 43 105 105 105 105 
105 105 105 105 24 25 26 27 24 25 26 27 24 25 26 27 24 25 26 27 24 25 26 27 24 121 122 27 105 105 105 105 
105 105 105 105 28 29 30 31 28 29 30 31 28 29 30 31 28 29 30 31 28 29 30 31 28 123 124 31 105 105 105 105 
105 105 105 105 32 33 34 35 32 33 34 35 105 105 105 105 105 105 105 105 105 105 105 105 105 105 105 105 105 105 105 105 
105 105 105 105 36 37 38 39 36 37 38 39 40 119 120 43 40 41 42 43 40 119 120 43 40 41 42 43 105 105 105 105 
105 105 105 105 24 25 26 27 24 25 26 27 24 121 122 27 24 25 26 27 24 121 122 27 24 25 26 27 105 105 105 105 
105 105 105 105 28 29 30 31 28 29 30 31 28 123 124 31 28 29 30 31 28 123 124 31 28 29 30 31 105 105 105 105 
105 105 105 105 105 105 105 105 105 105 105 105 105 105 105 105 105 105 105 105 105 105 105 105 105 105 105 105 105 105 105 105 
105 105 105 105 105 105 105 105 105 105 105 105 105 105 105 105 105 105 105 105 105 105 105 105 105 105 105 105 105 105 105 105 
105 105 105 105 105 105 105 105 105 105 105 105 105 105 105 105 105 105 105 105 105 105 105 105 105 105 105 105 105 105 105 105 
105 105 105 105 105 105 105 105 105 105 105 105 105 105 105 105 105 105 105 105 105 105 105 105 105 105 105 105 105 105 105 105 
105 105 105 105 105 105 105 105 105 105 105 105 105 105 105 105 105 105 105 105 105 105 105 105 105 105 105 105 105 105 105 105 

11 
LADDER 144 0 3 0
LADDER 128 128 7 0
LADDER 256 64 7 0
STONE 240 208 -3
STONE 368 144 0
ENEMY SKELETON 384 208
ENEMY SKELETON 128 80
ENEMY SKELETON 128 16
ENEMY BOUNCINGBALL 288 32 2
ENEMY BOUNCINGBALL 320 160 3
ENEMY BOUNCINGBALL 192 224 4
