32 20
4 5 6 7 4 5 6 7 4 5 6 7 4 5 6 7 4 5 6 7 4 5 6 7 4 5 6 7 105 105 105 105 
8 9 10 11 8 9 10 11 8 9 10 11 8 9 10 11 8 9 10 11 8 9 10 11 8 9 10 11 105 105 105 105 
12 13 14 15 12 13 14 15 12 13 14 15 12 13 14 15 12 13 14 15 12 13 14 15 12 13 14 15 105 105 105 105 
105 105 105 105 16 17 18 19 16 17 18 19 105 105 105 105 105 105 105 105 106 106 18 19 16 17 18 19 105 105 105 105 
105 105 105 105 4 5 6 7 4 5 6 7 105 105 105 105 105 105 105 105 20 21 6 7 4 5 6 7 105 105 105 105 
105 105 105 105 8 9 10 11 8 9 10 11 105 105 105 105 105 105 105 105 8 9 10 11 8 9 10 11 105 105 105 105 
105 105 105 105 12 13 14 15 12 13 14 15 105 105 105 105 105 105 105 105 12 13 14 15 12 13 14 15 105 105 105 105 
105 105 105 105 105 105 105 105 106 106 18 19 105 105 105 105 105 105 105 105 16 17 18 19 16 17 105 105 105 105 105 105 
105 105 105 105 105 105 105 105 20 21 6 7 105 105 105 105 105 105 105 105 4 5 6 7 4 5 20 21 105 105 105 105 
105 105 105 105 105 105 105 105 8 9 10 11 105 105 105 105 105 105 105 105 8 9 10 11 8 9 10 11 105 105 105 105 
105 105 105 105 105 105 105 105 12 13 14 15 105 105 105 105 105 105 105 105 12 13 14 15 12 13 14 15 105 105 105 105 
105 105 105 105 105 105 105 105 16 17 18 19 105 105 105 105 105 105 105 105 16 17 18 19 105 105 105 105 105 105 105 105 
20 21 20 21 20 21 20 21 4 5 6 7 20 21 20 21 20 21 20 21 4 5 6 7 105 105 105 105 105 105 105 105 
8 9 10 11 8 9 10 11 8 9 10 11 8 9 10 11 8 9 10 11 8 9 10 11 105 105 105 105 105 105 105 105 
12 13 14 15 12 13 14 15 12 13 14 15 12 13 14 15 12 13 14 15 12 13 14 15 105 105 105 105 105 105 105 105 
105 105 105 105 105 105 105 105 105 105 105 105 16 17 18 19 105 105 105 105 105 105 18 19 105 105 105 105 105 105 105 105 
20 155 156 21 20 21 105 105 105 105 105 105 4 5 6 7 105 105 105 105 105 105 6 7 20 155 156 21 20 21 20 21 
8 157 158 11 8 9 105 105 105 105 105 105 8 9 10 11 105 105 105 105 105 105 10 11 8 157 158 11 8 9 10 11 
12 159 160 15 12 13 105 105 105 105 105 105 12 13 14 15 105 105 105 105 105 105 14 15 12 159 160 15 12 13 14 15 
105 105 105 105 105 105 105 105 105 105 105 105 105 105 105 105 105 105 105 105 105 105 105 105 105 105 105 105 105 105 105 105 

9 
LADDER 320 64 11 0
LADDER 128 128 7 0
LADDER 224 0 3 0
KEYDOOR 288 192 1
STONE 64 80 0
STONE 224 272 -2
ENEMY KNIGHT 112 80
ENEMY KNIGHT 288 16
ENEMY KNIGHT 400 144
