32 20
105 105 38 39 36 37 38 39 36 37 38 39 36 37 38 39 36 37 38 39 36 37 38 39 36 37 38 39 36 37 105 105 
105 105 26 27 24 25 26 27 24 25 26 27 24 25 26 27 24 25 26 27 24 25 26 27 24 25 26 27 24 25 105 105 
105 105 30 31 28 29 30 31 28 29 30 31 28 29 30 31 28 29 30 31 28 29 30 31 28 29 30 31 28 29 105 105 
105 105 105 105 105 105 105 105 105 105 105 105 105 105 34 35 32 33 105 105 105 105 105 105 105 105 105 105 105 105 105 105 
105 105 42 43 40 119 120 43 40 41 42 43 40 41 38 39 36 37 42 43 40 41 42 43 40 119 120 43 40 41 105 105 
105 105 26 27 24 121 122 27 24 25 26 27 24 25 26 27 24 25 26 27 24 25 26 27 24 121 122 27 24 25 105 105 
105 105 30 31 28 123 124 31 28 29 30 31 28 29 30 31 28 29 30 31 28 29 30 31 28 123 124 31 28 29 105 105 
105 105 105 105 106 106 105 105 32 33 34 35 32 33 34 35 32 33 34 35 32 33 34 35 105 105 106 106 105 105 105 105 
105 105 42 43 40 41 42 43 36 37 38 39 36 37 38 39 36 37 38 39 36 37 38 39 40 41 42 43 40 41 105 105 
105 105 26 27 24 25 26 27 24 25 26 27 24 25 26 27 24 25 26 27 24 25 26 27 24 25 26 27 24 25 105 105 
105 105 30 31 28 29 30 31 28 29 30 31 28 29 30 31 28 29 30 31 28 29 30 31 28 29 30 31 28 29 105 105 
105 105 34 35 32 33 34 35 32 33 34 35 32 33 34 35 32 33 34 35 32 33 34 35 32 33 34 35 32 33 105 105 
105 105 38 39 36 37 38 39 36 37 38 39 36 37 38 39 36 37 38 39 36 37 38 39 36 37 38 39 36 37 105 105 
105 105 26 27 24 25 26 27 24 25 26 27 24 25 26 27 24 25 26 27 24 25 26 27 24 25 26 27 24 25 105 105 
105 105 30 31 28 29 30 31 28 29 30 31 28 29 30 31 28 29 30 31 28 29 30 31 28 29 30 31 28 29 105 105 
105 105 34 35 32 33 34 35 32 33 34 35 32 33 34 35 32 33 34 35 32 33 34 35 32 33 34 35 32 33 105 105 
105 105 38 39 36 37 38 39 36 37 38 39 36 37 38 39 36 37 38 39 36 37 38 39 36 37 38 39 36 37 105 105 
105 105 26 27 24 25 26 27 24 25 26 27 24 25 26 27 24 25 26 27 24 25 26 27 24 25 26 27 24 25 105 105 
105 105 30 31 28 29 30 31 28 29 30 31 28 29 30 31 28 29 30 31 28 29 30 31 28 29 30 31 28 29 105 105 
105 105 105 105 105 105 105 105 32 33 34 35 32 33 34 35 32 33 34 35 32 33 34 35 32 33 34 35 32 33 105 105 

6 
LADDER 416 128 13 0
LADDER 64 128 11 0
DOOR 144 16 1
STONE 448 80 0
STONE 320 16 0
STONE 144 16 0

SLIME