32 20
48 49 50 51 48 49 50 51 48 49 50 51 48 49 50 51 48 49 50 51 48 49 50 51 48 49 50 51 48 49 105 105 
52 53 54 55 52 53 54 55 52 53 54 55 52 53 54 55 52 53 54 55 52 53 54 55 52 53 54 55 52 53 105 105 
56 57 58 59 56 57 58 59 56 57 58 59 56 57 58 59 56 57 58 59 56 57 58 59 56 57 58 59 56 57 105 105 
44 45 46 47 44 45 46 47 105 105 105 105 105 105 105 105 105 105 105 105 105 105 46 47 44 45 46 47 44 45 105 105 
48 49 50 51 48 49 50 51 60 61 62 61 60 70 71 63 60 61 62 63 60 61 50 51 48 49 50 51 48 49 105 105 
52 53 54 55 52 53 54 55 52 53 54 55 52 72 73 55 52 53 54 55 52 53 54 55 52 53 54 55 52 53 105 105 
56 57 58 59 56 57 58 59 56 57 58 59 56 74 75 59 56 57 58 59 56 57 58 59 56 57 58 59 56 57 105 105 
105 105 105 105 44 45 46 47 44 45 46 47 105 105 105 105 44 45 46 47 105 105 105 105 105 105 105 105 105 105 105 105 
60 61 62 63 48 49 50 51 48 49 50 51 60 61 62 63 48 49 50 51 60 61 62 63 60 61 62 63 60 61 62 63 
52 53 54 55 52 53 54 55 52 53 54 55 52 53 54 55 52 53 54 55 52 53 54 55 52 53 54 55 52 53 54 55 
56 57 58 59 56 57 58 59 56 57 58 59 56 57 58 59 56 57 58 59 56 57 58 59 56 57 58 59 56 57 58 59 
44 45 46 47 44 45 46 47 44 45 46 47 44 45 46 47 44 45 46 47 44 45 46 47 44 45 46 47 44 45 46 47 
163 163 163 163 163 163 163 163 163 163 163 163 163 163 163 163 163 163 163 163 163 163 163 163 163 163 163 163 163 163 163 163 
164 164 164 164 164 164 164 164 164 164 164 164 164 164 164 164 164 164 164 164 164 164 164 164 164 164 164 164 164 164 164 164 
164 164 164 164 164 164 164 164 164 164 164 164 164 164 164 164 164 164 164 164 164 164 164 164 164 164 164 164 164 164 164 164 
164 164 164 164 164 164 164 164 164 164 164 164 164 164 164 164 164 164 164 164 164 164 164 164 164 164 164 164 164 164 164 164 
164 164 164 164 164 164 164 164 164 164 164 164 164 164 164 164 164 164 164 164 164 164 164 164 164 164 164 164 164 164 164 164 
164 164 164 164 164 164 164 164 164 164 164 164 164 164 164 164 164 164 164 164 164 164 164 164 164 164 164 164 164 164 164 164 
164 164 164 164 164 164 164 164 164 164 164 164 164 164 164 164 164 164 164 164 164 164 164 164 164 164 164 164 164 164 164 164 
165 165 165 165 165 165 165 165 165 165 165 165 165 165 165 165 165 165 165 165 165 165 165 165 165 165 165 165 165 165 165 165 

2 
LADDER 320 0 3 0
STONE 192 16 -3

LAVA