32 20
36 37 38 39 36 37 38 39 36 37 38 39 36 37 38 39 36 37 38 39 36 37 38 39 36 37 38 39 105 105 105 105 
24 25 26 27 24 25 26 27 24 25 26 27 24 25 26 27 24 25 26 27 24 25 26 27 24 25 26 27 105 105 105 105 
28 29 30 31 28 29 30 31 28 29 30 31 28 29 30 31 28 29 30 31 28 29 30 31 28 29 30 31 105 105 105 105 
32 33 34 35 32 33 34 35 32 33 34 35 32 33 34 35 32 33 34 35 32 33 34 35 32 33 34 35 105 105 105 105 
36 37 38 39 36 37 38 39 36 37 38 39 36 37 38 39 36 37 38 39 36 37 38 39 36 37 38 39 105 105 105 105 
24 25 26 27 24 25 26 27 24 25 26 27 24 25 26 27 24 25 26 27 24 25 26 27 24 25 26 27 105 105 105 105 
28 29 30 31 28 29 30 31 28 29 30 31 28 29 30 31 28 29 30 31 28 29 30 31 28 29 30 31 105 105 105 105 
105 105 105 105 32 33 34 35 32 33 34 35 32 33 34 35 32 33 34 35 32 33 34 35 32 33 34 35 105 105 105 105 
105 105 105 105 36 37 38 39 36 37 38 39 36 37 38 39 36 37 38 39 36 37 38 39 36 37 38 39 105 105 105 105 
105 105 105 105 24 25 26 27 24 25 26 27 24 25 26 27 24 25 26 27 24 25 26 27 24 25 26 27 105 105 105 105 
105 105 105 105 28 29 30 31 28 29 30 31 28 29 30 31 28 29 30 31 28 29 30 31 28 29 30 31 105 105 105 105 
105 105 105 105 32 33 34 35 32 33 34 35 32 33 34 35 32 33 34 35 32 33 34 35 32 33 34 35 105 105 105 105 
40 119 120 43 36 37 38 39 36 37 38 39 36 37 38 39 36 37 38 39 36 37 38 39 36 37 38 39 105 105 105 105 
24 121 122 27 24 25 26 27 24 25 26 27 24 25 26 27 24 25 26 27 24 25 26 27 24 25 26 27 105 105 105 105 
28 123 124 31 28 29 30 31 28 29 30 31 28 29 30 31 28 29 30 31 28 29 30 31 28 29 30 31 105 105 105 105 
105 105 105 105 32 33 34 35 32 33 34 35 32 33 34 35 32 33 34 35 32 33 34 35 32 33 34 35 105 105 105 105 
105 105 105 105 36 37 38 39 36 37 38 39 36 37 38 39 36 37 38 39 36 37 38 39 36 37 38 39 105 105 105 105 
105 105 105 105 24 25 26 27 24 25 26 27 24 25 26 27 24 25 26 27 24 25 26 27 24 25 26 27 105 105 105 105 
105 105 105 105 28 29 30 31 28 29 30 31 28 29 30 31 28 29 30 31 28 29 30 31 28 29 30 31 105 105 105 105 
105 105 105 105 105 105 105 105 105 105 105 105 105 105 34 35 32 33 105 105 105 105 105 105 105 105 105 105 105 105 105 105 

7 
STONE 352 272 -1
ENEMY BAT 448 192
ENEMY BAT 448 64
ENEMY BAT 32 0
ENEMY SMOKE 192 272 0
ENEMY SMOKE 128 272 0
ENEMY SMOKE 320 272 0
