32 20
105 105 105 105 48 49 50 51 48 49 50 51 48 49 50 51 48 49 50 51 48 49 50 51 48 49 50 51 105 105 105 105 
105 105 105 105 52 53 54 55 52 53 54 55 52 53 54 55 52 53 54 55 52 53 54 55 52 53 54 55 105 105 105 105 
105 105 105 105 56 57 58 59 56 57 58 59 56 57 58 59 56 57 58 59 56 57 58 59 56 57 58 59 105 105 105 105 
105 105 105 105 44 45 46 47 44 45 46 47 44 45 46 47 105 105 105 105 44 45 46 47 44 45 46 47 105 105 105 105 
60 61 62 63 48 49 50 51 48 49 50 51 48 49 50 51 60 61 62 63 48 49 50 51 48 49 50 51 105 105 105 105 
52 53 54 55 52 53 54 55 52 53 54 55 52 53 54 55 52 53 54 55 52 53 54 55 52 53 54 55 105 105 105 105 
56 57 58 59 56 57 58 59 56 57 58 59 56 57 58 59 56 57 58 59 56 57 58 59 56 57 58 59 105 105 105 105 
44 45 46 47 44 45 46 47 105 105 105 105 44 45 46 47 44 45 46 47 44 45 46 47 105 105 105 105 105 105 105 105 
48 49 50 51 48 49 50 51 60 61 62 63 48 49 50 51 48 49 50 51 48 49 50 51 60 61 62 63 105 105 105 105 
52 53 54 55 52 53 54 55 52 53 54 55 52 53 54 55 52 53 54 55 52 53 54 55 52 53 54 55 105 105 105 105 
56 57 58 59 56 57 58 59 56 57 58 59 56 57 58 59 56 57 58 59 56 57 58 59 56 57 58 59 105 105 105 105 
44 45 46 47 44 45 46 47 44 45 46 47 44 45 46 47 44 45 46 47 44 45 46 47 44 45 46 47 105 105 105 105 
163 163 163 163 163 163 163 163 163 163 163 163 163 163 163 163 163 163 163 163 163 163 163 163 163 163 163 163 105 105 105 105 
164 164 164 164 164 164 164 164 164 164 164 164 164 164 164 164 164 164 164 164 164 164 164 164 164 164 164 164 105 105 105 105 
164 164 164 164 164 164 164 164 164 164 164 164 164 164 164 164 164 164 164 164 164 164 164 164 164 164 164 164 105 105 105 105 
164 164 164 164 164 164 164 164 164 164 164 164 164 164 164 164 164 164 164 164 164 164 164 164 164 164 164 164 105 105 105 105 
164 164 164 164 164 164 164 164 164 164 164 164 164 164 164 164 164 164 164 164 164 164 164 164 164 164 164 164 105 105 105 105 
164 164 164 164 164 164 164 164 164 164 164 164 164 164 164 164 164 164 164 164 164 164 164 164 164 164 164 164 105 105 105 105 
164 164 164 164 164 164 164 164 164 164 164 164 164 164 164 164 164 164 164 164 164 164 164 164 164 164 164 164 105 105 105 105 
165 165 165 165 165 165 165 165 165 165 165 165 165 165 165 165 165 165 165 165 165 165 165 165 165 165 165 165 105 105 105 105 

2 
LADDER 384 0 7 0
STONE 128 80 36

LAVA