32 20
105 105 38 39 36 37 105 105 105 105 105 105 36 37 38 39 36 37 38 39 36 37 38 39 36 37 38 39 36 37 105 105 
105 105 26 27 24 25 105 105 105 105 105 105 24 25 26 27 24 25 26 27 24 25 26 27 24 25 26 27 24 25 105 105 
105 105 30 31 28 29 105 105 105 105 105 105 28 29 30 31 28 29 30 31 28 29 30 31 28 29 30 31 28 29 105 105 
105 105 105 105 106 106 105 105 105 105 105 105 105 105 105 105 32 33 34 35 105 105 105 105 105 105 105 105 105 105 105 105 
105 105 42 43 40 41 105 105 105 105 105 105 40 41 42 43 36 37 38 39 36 37 38 39 36 37 38 39 36 119 120 39 
105 105 26 27 24 25 105 105 105 105 105 105 24 25 26 27 24 25 26 27 24 25 26 27 24 25 26 27 24 121 122 27 
105 105 30 31 28 29 105 105 105 105 105 105 28 29 30 31 28 29 30 31 28 29 30 31 28 29 30 31 28 123 124 31 
105 105 34 35 32 33 105 105 105 105 105 105 32 33 34 35 105 105 105 105 106 106 34 35 32 33 105 105 105 105 105 105 
105 105 38 39 36 37 105 105 105 105 105 105 36 37 38 39 40 41 42 43 40 41 38 39 36 37 42 43 40 41 105 105 
105 105 26 27 24 25 105 105 105 105 105 105 24 25 26 27 24 25 26 27 24 25 26 27 24 25 26 27 24 25 105 105 
105 105 30 31 28 29 105 105 105 105 105 105 28 29 30 31 28 29 30 31 28 29 30 31 28 29 30 31 28 29 105 105 
105 105 34 35 105 105 105 105 105 105 105 105 105 105 105 105 32 33 34 35 105 105 105 105 32 33 34 35 32 33 105 105 
105 105 38 39 40 41 105 105 105 105 105 105 40 41 42 43 36 37 38 39 40 41 42 43 36 37 38 39 36 37 105 105 
105 105 26 27 24 25 105 105 105 105 105 105 24 25 26 27 24 25 26 27 24 25 26 27 24 25 26 27 24 25 105 105 
105 105 30 31 28 29 105 105 105 105 105 105 28 29 30 31 28 29 30 31 28 29 30 31 28 29 30 31 28 29 105 105 
105 105 105 105 32 33 105 105 105 105 105 105 105 105 105 105 105 105 105 105 105 105 105 105 105 105 105 105 105 105 105 105 
105 105 42 43 36 37 42 43 40 119 120 43 40 41 42 43 40 119 120 43 40 41 42 43 40 119 120 43 40 41 42 43 
105 105 26 27 24 25 26 27 24 121 122 27 24 25 26 27 24 121 122 27 24 25 26 27 24 121 122 27 24 25 26 27 
105 105 30 31 28 29 30 31 28 123 124 31 28 29 30 31 28 123 124 31 28 29 30 31 28 123 124 31 28 29 30 31 
105 105 105 105 105 105 105 105 105 105 105 105 105 105 105 105 105 105 105 105 105 105 105 105 105 105 105 105 105 105 105 105 

11
LADDER 224 0 3 0
LADDER 32 0 3 0
LADDER 64 64 7 0
LADDER 320 128 3 0
ITEM 64 32 34
STONE 432 208 0
STONE 176 272 0
ENEMY KNIGHT 384 272
ENEMY KNIGHT 384 208
ENEMY KNIGHT 384 16
ENEMY KNIGHT 288 80
