32 20
36 37 38 39 36 37 38 39 36 37 38 39 36 37 38 39 36 37 38 39 36 37 38 39 36 37 38 39 36 37 38 39 
24 25 26 27 24 25 26 27 24 25 26 27 24 25 26 27 24 25 26 27 24 25 26 27 24 25 26 27 24 25 26 27 
28 29 30 31 28 29 30 31 28 29 30 31 28 29 30 31 28 29 30 31 28 29 30 31 28 29 30 31 28 29 30 31 
32 33 34 35 105 105 105 105 105 105 105 105 105 105 105 105 32 33 34 35 105 105 105 105 105 105 105 105 32 33 34 35 
36 37 38 39 40 41 42 43 40 41 42 43 40 41 42 43 36 37 38 39 40 119 120 43 40 41 42 43 36 37 38 39 
24 25 26 27 24 25 26 27 24 25 26 27 24 25 26 27 24 25 26 27 24 121 122 27 24 25 26 27 24 25 26 27 
28 29 30 31 28 29 30 31 28 29 30 31 28 29 30 31 28 29 30 31 28 123 124 31 28 29 30 31 28 29 30 31 
105 105 105 105 105 105 105 105 32 33 34 35 32 33 34 35 105 105 105 105 105 105 105 105 32 33 34 35 105 105 105 105 
105 105 105 105 40 41 42 43 36 37 38 39 36 37 38 39 40 41 42 43 105 105 105 105 36 37 38 39 105 105 105 105 
105 105 105 105 24 25 26 27 24 25 26 27 24 25 26 27 24 25 26 27 105 105 105 105 24 25 26 27 105 105 105 105 
105 105 105 105 28 29 30 31 28 29 30 31 28 29 30 31 28 29 30 31 105 105 105 105 28 29 30 31 105 105 105 105 
105 105 105 105 32 33 34 35 32 33 34 35 105 105 105 105 32 33 34 35 105 105 105 105 32 33 34 35 105 105 105 105 
105 105 105 105 36 37 38 39 36 37 38 39 105 105 105 105 36 37 38 39 105 105 105 105 36 37 38 39 40 41 42 43 
105 105 105 105 24 25 26 27 24 25 26 27 105 105 105 105 24 25 26 27 105 105 105 105 24 25 26 27 24 25 26 27 
105 105 105 105 28 29 30 31 28 29 30 31 105 105 105 105 28 29 30 31 105 105 105 105 28 29 30 31 28 29 30 31 
105 105 105 105 32 33 34 35 105 105 105 105 105 105 105 105 32 33 34 35 105 105 105 105 105 105 105 105 32 33 105 105 
40 119 120 43 36 37 38 39 40 41 42 43 40 119 120 43 36 37 38 39 40 119 120 43 40 41 42 43 36 37 105 105 
24 121 122 27 24 25 26 27 24 25 26 27 24 121 122 27 24 25 26 27 24 121 122 27 24 25 26 27 24 25 105 105 
28 123 124 31 28 29 30 31 28 29 30 31 28 123 124 31 28 29 30 31 28 123 124 31 28 29 30 31 28 29 105 105 
105 105 105 105 105 105 105 105 105 105 105 105 105 105 105 105 105 105 105 105 105 105 105 105 105 105 105 105 105 105 105 105 

7 
STONE 288 272 0
ENEMY BOUNCINGBALL 384 288 2
ENEMY BOUNCINGBALL 224 288 3
ENEMY BOUNCINGBALL 128 288 4
ENEMY BOUNCINGBALL 96 96 3
ENEMY BOUNCINGBALL 224 32 2
ENEMY BOUNCINGBALL 352 96 3
