32 20
105 105 105 105 105 105 105 105 105 105 105 105 105 105 105 105 36 37 38 39 36 37 38 39 36 37 38 39 36 37 105 105 
105 105 105 105 105 105 105 105 105 105 105 105 105 105 105 105 24 25 26 27 24 25 26 27 24 25 26 27 24 25 105 105 
105 105 105 105 105 105 105 105 105 105 105 105 105 105 105 105 28 29 30 31 28 29 30 31 28 29 30 31 28 29 105 105 
105 105 105 105 105 105 105 105 105 105 105 105 105 105 105 105 32 33 34 35 105 105 105 105 105 105 34 35 32 33 105 105 
105 105 105 105 105 105 105 105 105 105 105 105 105 105 105 105 36 37 38 39 105 105 105 105 40 41 38 39 36 37 105 105 
105 105 105 105 105 105 105 105 105 105 105 105 105 105 105 105 24 25 26 27 105 105 105 105 24 25 26 27 24 25 105 105 
105 105 105 105 105 105 105 105 105 105 105 105 105 105 105 105 28 29 30 31 105 105 105 105 28 29 30 31 28 29 105 105 
105 105 105 105 105 105 105 105 105 105 105 105 105 105 105 105 105 105 34 35 105 105 105 105 105 105 106 106 105 105 105 105 
40 119 120 43 40 41 42 43 40 119 120 43 40 41 42 43 40 41 38 39 105 105 105 105 40 41 42 43 40 41 105 105 
24 121 122 27 24 25 26 27 24 121 122 27 24 25 26 27 24 25 26 27 105 105 105 105 24 25 26 27 24 25 105 105 
28 123 124 31 28 29 30 31 28 123 124 31 28 29 30 31 28 29 30 31 105 105 105 105 28 29 30 31 28 29 105 105 
105 105 105 105 105 105 105 105 105 105 105 105 105 105 105 105 105 105 105 105 105 105 105 105 32 33 34 35 32 33 105 105 
105 105 105 105 105 105 105 105 105 105 105 105 105 105 105 105 40 119 120 43 40 41 42 43 36 37 38 39 36 37 105 105 
105 105 105 105 105 105 105 105 105 105 105 105 105 105 105 105 24 121 122 27 24 25 26 27 24 25 26 27 24 25 105 105 
105 105 105 105 105 105 105 105 105 105 105 105 105 105 105 105 28 123 124 31 28 29 30 31 28 29 30 31 28 29 105 105 
105 105 105 105 105 105 105 105 105 105 105 105 105 105 105 105 105 105 106 106 105 105 105 105 105 105 105 105 105 105 105 105 
105 105 105 105 105 105 105 105 105 105 105 105 105 105 105 105 40 41 42 43 40 119 120 43 40 41 42 43 40 41 105 105 
105 105 105 105 105 105 105 105 105 105 105 105 105 105 105 105 24 25 26 27 24 121 122 27 24 25 26 27 24 25 105 105 
105 105 105 105 105 105 105 105 105 105 105 105 105 105 105 105 28 29 30 31 28 123 124 31 28 29 30 31 28 29 105 105 
105 105 105 105 105 105 105 105 105 105 105 105 105 105 105 105 105 105 105 105 105 105 105 105 105 105 105 105 105 105 105 105 

2 
LADDER 288 256 3 0
LADDER 416 128 7 0

BUTTERFLY