32 20
125 125 125 125 127 128 127 128 127 128 127 128 127 128 127 128 127 128 127 128 127 128 127 128 127 128 127 128 127 128 127 128 
125 125 125 125 129 130 129 130 129 130 129 130 129 130 129 130 129 130 129 130 129 130 129 130 129 130 129 130 129 130 129 130 
125 125 125 125 128 127 128 127 128 127 128 127 128 127 128 127 128 127 128 127 128 127 128 127 128 127 128 127 128 127 128 127 
125 125 125 125 130 129 130 129 130 129 125 125 125 125 125 125 125 125 125 125 125 125 125 125 125 126 126 125 130 129 125 125 
125 125 125 125 127 128 127 128 127 128 131 132 131 132 131 132 131 132 131 132 131 132 131 132 131 132 131 132 127 128 125 125 
125 125 125 125 129 130 129 130 129 130 129 130 129 130 129 130 129 130 129 130 129 130 129 130 129 130 129 130 129 130 125 125 
125 125 125 125 128 127 128 127 128 127 128 127 128 127 128 127 128 127 128 127 128 127 128 127 128 127 128 127 128 127 125 125 
125 125 125 125 130 129 130 129 130 129 130 129 130 129 125 125 125 125 130 129 130 129 130 129 130 129 130 129 130 129 125 125 
125 125 125 125 127 128 127 128 127 128 127 128 127 128 125 125 125 125 127 128 127 128 127 128 127 128 127 128 127 128 125 125 
125 125 125 125 129 130 129 130 129 130 129 130 129 130 125 125 125 125 129 130 129 130 129 130 129 130 129 130 129 130 125 125 
125 125 125 125 128 127 128 127 128 127 128 127 128 127 125 125 125 125 128 127 128 127 128 127 128 127 128 127 128 127 125 125 
125 125 125 125 130 129 130 129 130 129 125 125 125 125 125 125 125 125 130 129 130 129 130 129 130 129 130 129 130 129 125 125 
125 125 125 125 127 128 127 128 127 128 125 125 125 125 125 125 125 125 127 128 127 128 127 128 127 128 127 128 127 128 125 125 
125 125 125 125 129 130 129 130 129 130 125 125 125 125 125 125 125 125 129 130 129 130 129 130 129 130 129 130 129 130 125 125 
125 125 125 125 128 127 128 127 128 127 125 125 125 125 125 125 125 125 128 127 128 127 128 127 128 127 128 127 128 127 125 125 
125 125 125 125 130 129 125 125 125 125 125 125 125 125 125 125 125 125 125 125 125 125 125 125 125 125 125 125 125 125 125 125 
125 125 125 125 127 128 131 132 131 132 131 132 131 132 131 132 131 132 131 135 136 132 131 132 131 132 131 132 131 132 131 132 
125 125 125 125 129 130 129 130 129 130 129 130 129 130 129 130 129 130 129 137 138 130 129 130 129 130 129 130 129 130 129 130 
125 125 125 125 128 127 128 127 128 127 128 127 128 127 128 127 128 127 128 139 140 127 128 127 128 127 128 127 128 127 128 127 
125 125 125 125 125 125 125 125 125 125 125 125 125 125 125 125 125 125 125 125 125 125 125 125 125 125 125 125 125 125 125 125 

15 
LADDER 400 64 11 0
TOMB 400 16
WKEYDOOR 208 256 1
LADDER 208 0 3 0
WITEM 288 208 1
ENEMY BLUESPIDER 128 208
ENEMY BLUESPIDER 160 144
ENEMY BLUESPIDER 416 208
ENEMY BLUESPIDER 288 16
ENEMY WHITEFIREBALL 192 208
ENEMY WHITEFIREBALL 192 208
ENEMY WHITEFIREBALL 192 208
ENEMY WHITEFIREBALL 192 208
ENEMY WHITEFIREBALL 192 208
ENEMY WHITEFIREBALL 192 208

