32 20
125 125 125 125 125 125 125 125 127 128 127 128 125 125 125 125 125 125 125 125 127 128 127 128 127 128 127 128 127 128 125 125 
125 125 125 125 125 125 125 125 129 130 129 130 125 125 125 125 125 125 125 125 129 130 129 130 129 130 129 130 129 130 125 125 
125 125 125 125 125 125 125 125 128 127 128 127 125 125 125 125 125 125 125 125 128 127 128 127 128 127 128 127 128 127 125 125 
125 125 125 125 125 125 125 125 130 129 130 129 125 125 125 125 125 125 125 125 125 125 125 125 125 125 125 125 130 129 125 125 
125 125 125 125 125 125 125 125 127 128 127 128 131 132 131 132 131 132 131 132 131 132 131 132 131 132 131 132 127 128 125 125 
125 125 125 125 125 125 125 125 129 130 129 130 129 130 129 130 129 130 129 130 129 130 129 130 129 130 129 130 129 130 125 125 
125 125 125 125 125 125 125 125 128 127 128 127 128 127 128 127 128 127 128 127 128 127 128 127 128 127 128 127 128 127 125 125 
125 125 125 125 125 125 125 125 130 129 130 129 130 129 130 129 130 129 130 129 125 125 125 125 125 125 125 125 125 125 125 125 
125 125 125 125 125 125 125 125 127 128 127 128 127 128 127 128 127 128 127 128 131 132 131 132 131 132 131 132 125 125 125 125 
125 125 125 125 125 125 125 125 129 130 129 130 129 130 129 130 129 130 129 130 129 130 129 130 129 130 129 130 125 125 125 125 
125 125 125 125 125 125 125 125 128 127 128 127 128 127 128 127 128 127 128 127 128 127 128 127 128 127 128 127 125 125 125 125 
125 125 125 125 125 125 125 125 130 129 130 129 125 125 125 126 126 125 125 125 130 129 130 129 125 125 125 125 125 125 125 125 
125 125 125 125 125 125 125 125 127 128 127 128 131 132 131 132 131 132 131 132 127 128 127 128 131 132 131 132 131 132 125 125 
125 125 125 125 125 125 125 125 129 130 129 130 129 130 129 130 129 130 129 130 129 130 129 130 129 130 129 130 129 130 125 125 
125 125 125 125 125 125 125 125 128 127 128 127 128 127 128 127 128 127 128 127 128 127 128 127 128 127 128 127 128 127 125 125 
125 125 125 125 125 125 125 125 130 129 130 129 130 129 130 129 130 129 130 129 130 129 130 129 130 129 130 129 130 129 125 125 
125 125 125 125 125 125 125 125 127 128 127 128 127 128 127 128 127 128 127 128 127 128 127 128 127 128 127 128 127 128 125 125 
125 125 125 125 125 125 125 125 129 130 129 130 129 130 129 130 129 130 129 130 129 130 129 130 129 130 129 130 129 130 125 125 
125 125 125 125 125 125 125 125 128 127 128 127 128 127 128 127 128 127 128 127 128 127 128 127 128 127 128 127 128 127 125 125 
125 125 125 125 125 125 125 125 130 129 130 129 125 125 125 125 125 125 125 125 125 125 125 125 125 125 125 125 125 125 125 125 

5 
LADDER 240 192 7 0
LADDER 336 0 3 0
ENEMY JUMPINGBUSH 288 144
ENEMY BLUESPIDER 352 80
ENEMY JUMPINGBUSH 384 16
