32 20
127 128 127 128 127 128 127 128 127 128 127 128 127 128 127 128 127 128 127 128 127 128 127 128 127 128 127 128 125 125 125 125 
129 130 129 130 129 130 129 130 129 130 129 130 129 130 129 130 129 130 129 130 129 130 129 130 129 130 129 130 125 125 125 125 
128 127 128 127 128 127 128 127 128 127 128 127 128 127 128 127 128 127 128 127 128 127 128 127 128 127 128 127 125 125 125 125 
125 125 125 125 130 129 130 129 130 129 130 129 125 125 125 125 125 125 125 125 130 129 130 129 126 126 125 125 125 125 125 125 
125 125 125 125 127 128 127 128 127 128 127 128 131 132 131 132 131 132 131 132 127 128 127 128 131 132 131 132 125 125 125 125 
125 125 125 125 129 130 129 130 129 130 129 130 129 130 129 130 129 130 129 130 129 130 129 130 129 130 129 130 125 125 125 125 
125 125 125 125 128 127 128 127 128 127 128 127 128 127 128 127 128 127 128 127 128 127 128 127 128 127 128 127 125 125 125 125 
125 125 125 125 125 125 125 125 130 129 130 129 130 129 130 129 130 129 130 129 130 129 130 129 130 129 130 129 125 125 125 125 
125 125 125 125 131 132 131 132 127 128 127 128 127 128 127 128 127 128 127 128 127 128 127 128 127 128 127 128 131 132 125 125 
125 125 125 125 129 130 129 130 129 130 129 130 129 130 129 130 129 130 129 130 129 130 129 130 129 130 129 130 129 130 125 125 
125 125 125 125 128 127 128 127 128 127 128 127 128 127 128 127 128 127 128 127 128 127 128 127 128 127 128 127 128 127 125 125 
125 125 125 125 130 129 130 129 130 129 130 129 130 129 130 129 125 125 125 125 125 125 125 125 125 125 125 125 125 125 125 125 
125 125 125 125 127 128 127 128 127 128 127 128 127 128 127 128 131 132 131 132 131 135 136 132 131 132 131 132 131 132 125 125 
125 125 125 125 129 130 129 130 129 130 129 130 129 130 129 130 129 130 129 130 129 137 138 130 129 130 129 130 129 130 125 125 
125 125 125 125 128 127 128 127 128 127 128 127 128 127 128 127 128 127 128 127 128 139 140 127 128 127 128 127 128 127 125 125 
125 125 125 125 125 125 125 125 125 125 125 125 125 125 125 125 125 125 125 125 125 125 125 125 125 125 125 125 130 129 125 125 
131 132 131 132 131 132 131 132 131 135 136 132 131 132 131 132 131 135 136 132 131 132 131 132 131 132 131 132 127 128 125 125 
129 130 129 130 129 130 129 130 129 137 138 130 129 130 129 130 129 137 138 130 129 130 129 130 129 130 129 130 129 130 125 125 
128 127 128 127 128 127 128 127 128 139 140 127 128 127 128 127 128 139 140 127 128 127 128 127 128 127 128 127 128 127 125 125 
125 125 125 125 125 125 125 125 125 125 125 125 125 125 125 125 125 125 125 125 125 125 125 125 125 125 125 125 125 125 125 125 

6 
LADDER 384 64 7 0
TOMB 272 208
ENEMY BLUESPIDER 64 80
ENEMY BLUESPIDER 256 208
ENEMY BLUESPIDER 288 144
ENEMY BLUESPIDER 224 16
