32 20
125 125 127 128 127 128 127 128 127 128 127 128 127 128 127 128 127 128 127 128 127 128 127 128 127 128 127 128 127 128 125 125 
125 125 129 130 129 130 129 130 129 130 129 130 129 130 129 130 129 130 129 130 129 130 129 130 129 130 129 130 129 130 125 125 
125 125 128 127 128 127 128 127 128 127 128 127 128 127 128 127 128 127 128 127 128 127 128 127 128 127 128 127 128 127 125 125 
125 125 125 125 125 125 125 125 130 129 130 129 125 125 125 125 130 129 130 129 125 125 125 125 125 125 125 125 125 125 125 125 
131 132 131 132 131 135 136 132 127 128 127 128 125 125 125 125 127 128 127 128 131 132 131 132 131 135 136 132 131 132 125 125 
129 130 129 130 129 137 138 130 129 130 129 130 125 125 125 125 129 130 129 130 129 130 129 130 129 137 138 130 129 130 125 125 
128 127 128 127 128 139 140 127 128 127 128 127 125 125 125 125 128 127 128 127 128 127 128 127 128 139 140 127 128 127 125 125 
125 125 125 125 125 125 125 125 125 125 125 125 125 125 125 125 125 125 125 125 125 125 125 125 125 125 125 125 130 129 125 125 
125 125 131 132 131 132 131 132 131 132 131 132 131 132 131 132 131 132 131 132 131 132 131 132 131 132 131 132 127 128 125 125 
125 125 129 130 129 130 129 130 129 130 129 130 129 130 129 130 129 130 129 130 129 130 129 130 129 130 129 130 129 130 125 125 
125 125 128 127 128 127 128 127 128 127 128 127 128 127 128 127 128 127 128 127 128 127 128 127 128 127 128 127 128 127 125 125 
125 125 130 129 130 129 130 129 125 125 125 125 130 129 130 129 125 125 125 125 125 125 125 125 125 125 125 125 125 125 125 125 
125 125 127 128 127 128 127 128 125 125 125 125 127 128 127 128 131 135 136 132 131 132 131 132 131 132 131 132 131 132 125 125 
125 125 129 130 129 130 129 130 125 125 125 125 129 130 129 130 129 137 138 130 129 130 129 130 129 130 129 130 129 130 125 125 
125 125 128 127 128 127 128 127 125 125 125 125 128 127 128 127 128 139 140 127 128 127 128 127 128 127 128 127 128 127 125 125 
125 125 130 129 130 129 130 129 125 125 125 125 125 125 125 125 125 125 125 125 125 125 125 125 125 125 125 125 130 129 125 125 
131 132 127 128 127 128 127 128 131 135 136 132 131 132 131 132 131 132 131 132 131 135 136 132 131 132 131 132 127 128 125 125 
129 130 129 130 129 130 129 130 129 137 138 130 129 130 129 130 129 130 129 130 129 137 138 130 129 130 129 130 129 130 125 125 
128 127 128 127 128 127 128 127 128 139 140 127 128 127 128 127 128 127 128 127 128 139 140 127 128 127 128 127 128 127 125 125 
125 125 125 125 125 125 125 125 125 125 125 125 125 125 125 125 125 125 125 125 125 125 125 125 125 125 125 125 125 125 125 125 

19 
WKEYDOOR 320 128 1
WKEYDOOR 192 256 1
LADDER 80 0 3 0
TOMB 400 16
ENEMY BLACK 384 16
ENEMY BLACK 304 80
ENEMY BLACK 400 144
ENEMY BLACK 288 272
ENEMY BLACK 224 208
ENEMY WITCH 352 272
ENEMY WITCH 224 208
ENEMY WITCH 352 144
ENEMY WITCH 96 272
ENEMY WITCH 352 80
ENEMY WITCH 224 272
ENEMY WITCH 224 16
ENEMY WITCH 96 80
ENEMY WITCH 96 16
ENEMY WITCH 352 16
