32 20
125 125 127 128 127 128 127 128 127 128 127 128 127 128 127 128 127 128 127 128 127 128 127 128 127 128 125 125 125 125 125 125 
125 125 129 130 129 130 129 130 129 130 129 130 129 130 129 130 129 130 129 130 129 130 129 130 129 130 125 125 125 125 125 125 
125 125 128 127 128 127 128 127 128 127 128 127 128 127 128 127 128 127 128 127 128 127 128 127 128 127 125 125 125 125 125 125 
125 125 125 125 125 125 125 125 125 125 125 125 125 125 125 125 125 125 125 125 130 129 130 129 130 129 125 125 125 125 125 125 
125 125 131 132 131 135 136 132 131 132 131 132 131 132 131 132 131 132 131 132 127 128 127 128 127 128 125 125 125 125 125 125 
125 125 129 130 129 137 138 130 129 130 129 130 129 130 129 130 129 130 129 130 129 130 129 130 129 130 125 125 125 125 125 125 
125 125 128 127 128 139 140 127 128 127 128 127 128 127 128 127 128 127 128 127 128 127 128 127 128 127 125 125 125 125 125 125 
125 125 130 129 125 125 125 125 130 129 130 129 130 129 130 129 130 129 130 129 125 125 125 125 130 129 125 125 125 125 125 125 
125 125 127 128 131 132 131 132 127 128 127 128 127 128 127 128 127 128 127 128 131 132 131 132 127 128 125 125 125 125 125 125 
125 125 129 130 129 130 129 130 129 130 129 130 129 130 129 130 129 130 129 130 129 130 129 130 129 130 125 125 125 125 125 125 
125 125 128 127 128 127 128 127 128 127 128 127 128 127 128 127 128 127 128 127 128 127 128 127 128 127 125 125 125 125 125 125 
125 125 130 129 130 129 130 129 130 129 130 129 125 125 125 125 130 129 130 129 130 129 130 129 130 129 125 125 125 125 125 125 
125 125 127 128 127 128 127 128 127 128 127 128 131 132 131 132 127 128 127 128 127 128 127 128 127 128 125 125 125 125 125 125 
125 125 129 130 129 130 129 130 129 130 129 130 129 130 129 130 129 130 129 130 129 130 129 130 129 130 125 125 125 125 125 125 
125 125 128 127 128 127 128 127 128 127 128 127 128 127 128 127 128 127 128 127 128 127 128 127 128 127 125 125 125 125 125 125 
125 125 130 129 125 125 125 125 130 129 130 129 130 129 130 129 130 129 130 129 125 125 125 125 130 129 125 125 125 125 125 125 
125 125 127 128 131 135 136 132 127 128 127 128 127 128 127 128 127 128 127 128 131 135 136 132 127 128 125 125 125 125 125 125 
125 125 129 130 129 137 138 130 129 130 129 130 129 130 129 130 129 130 129 130 129 137 138 130 129 130 125 125 125 125 125 125 
125 125 128 127 128 139 140 127 128 127 128 127 128 127 128 127 128 127 128 127 128 139 140 127 128 127 125 125 125 125 125 125 
125 125 125 125 125 125 125 125 125 125 125 125 125 125 125 125 125 125 125 125 125 125 125 125 130 129 125 125 125 125 125 125 

7 
LADDER 96 0 3 0
TOMB 272 16
ENEMY JUMPINGBUSH 96 208
ENEMY JUMPINGBUSH 320 208
ENEMY JUMPINGBUSH 192 144
ENEMY JUMPINGBUSH 160 16
ENEMY JUMPINGBUSH 352 80
