32 20
125 125 125 125 125 125 125 125 125 125 125 125 125 125 125 128 0 125 125 125 125 125 125 125 127 128 125 125 125 125 125 125 
125 125 125 125 125 125 125 125 125 125 125 125 125 125 125 130 0 125 125 125 125 125 125 125 129 130 125 125 125 125 125 125 
125 125 125 125 125 125 125 125 125 125 125 125 125 125 125 127 0 125 125 125 125 125 125 125 128 127 125 125 125 125 125 125 
125 125 125 125 125 125 125 125 125 125 125 125 125 125 125 129 0 125 125 125 125 125 125 125 130 129 125 125 125 125 125 125 
125 125 125 125 125 125 125 125 125 125 125 125 125 125 125 128 0 125 125 125 125 125 125 125 127 128 125 125 125 125 125 125 
125 125 125 125 125 125 125 125 125 125 125 125 125 125 125 130 0 125 125 125 125 125 125 125 129 130 125 125 125 125 125 125 
125 125 125 125 125 125 125 125 125 125 125 125 125 125 125 127 0 125 125 125 125 125 125 125 128 127 125 125 125 125 125 125 
125 125 125 125 125 125 125 125 125 125 125 125 125 125 125 129 0 125 125 125 125 125 125 125 130 129 125 125 125 125 125 125 
125 125 125 125 125 125 125 125 125 125 125 125 125 125 125 128 0 125 125 125 125 125 125 125 127 128 125 125 125 125 125 125 
125 125 125 125 125 125 125 125 125 125 125 125 125 125 125 130 0 125 125 125 125 125 125 125 129 130 125 125 125 125 125 125 
125 125 125 125 125 125 125 125 125 125 125 125 125 125 125 127 0 125 125 125 125 125 125 125 128 127 125 125 125 125 125 125 
125 125 125 125 125 125 125 125 125 125 125 125 125 125 125 129 0 125 125 125 125 125 125 125 130 129 125 125 125 125 125 125 
125 125 125 125 125 125 125 125 125 125 125 125 125 125 125 128 0 125 125 125 125 125 125 125 127 128 125 125 125 125 125 125 
125 125 125 125 125 125 125 125 125 125 125 125 125 125 125 130 0 125 125 125 125 125 125 125 129 130 125 125 125 125 125 125 
125 125 125 125 125 125 125 125 125 125 125 125 125 125 125 127 0 125 125 125 125 125 125 125 128 127 125 125 125 125 125 125 
125 125 125 125 125 125 125 125 125 125 125 125 125 125 125 129 0 125 125 125 125 125 125 125 130 129 125 125 125 125 125 125 
125 125 125 125 125 125 125 125 125 125 125 125 125 125 125 128 0 125 125 125 125 125 125 125 127 128 125 125 125 125 125 125 
125 125 125 125 125 125 125 125 125 125 125 125 125 125 125 130 0 125 125 125 125 125 125 125 129 130 125 125 125 125 125 125 
125 125 125 125 125 125 125 125 125 125 125 125 125 125 125 127 0 125 125 125 125 125 125 125 128 127 125 125 125 125 125 125 
125 125 125 125 125 125 125 125 125 125 125 125 125 125 125 129 0 125 125 125 125 125 125 125 130 129 125 125 125 125 125 125 

5 
LADDER 240 0 21 0
ENEMY BAT 144 80
ENEMY BAT 448 272
ENEMY BAT 320 144
ENEMY BAT 144 208
