32 20
125 125 125 125 125 125 125 125 127 128 127 128 127 128 127 128 127 128 127 128 127 128 127 128 127 128 127 128 127 128 125 125 
125 125 125 125 125 125 125 125 129 130 129 130 129 130 129 130 129 130 129 130 129 130 129 130 129 130 129 130 129 130 125 125 
125 125 125 125 125 125 125 125 128 127 128 127 128 127 128 127 128 127 128 127 128 127 128 127 128 127 128 127 128 127 125 125 
125 125 125 125 125 125 125 125 125 125 125 125 125 125 125 125 125 125 125 125 125 125 125 125 126 126 125 125 125 125 125 125 
125 125 131 132 131 132 131 132 125 125 125 125 125 125 125 125 125 125 125 125 125 125 125 125 131 132 131 132 131 132 125 125 
125 125 129 130 129 130 129 130 125 125 125 125 125 125 125 125 125 125 125 125 125 125 125 125 129 130 129 130 129 130 125 125 
125 125 128 127 128 127 128 127 125 125 125 125 125 125 125 125 125 125 125 125 125 125 125 125 128 127 128 127 128 127 125 125 
125 125 126 126 125 125 125 125 125 125 125 125 125 125 125 125 125 125 125 125 125 125 125 125 125 125 125 125 126 126 125 125 
125 125 131 132 131 132 131 132 131 135 136 132 131 132 131 132 131 132 131 132 131 135 136 132 131 132 131 132 131 132 125 125 
125 125 129 130 129 130 129 130 129 137 138 130 129 130 129 130 129 130 129 130 129 137 138 130 129 130 129 130 129 130 125 125 
125 125 128 127 128 127 128 127 128 139 140 127 128 127 128 127 128 127 128 127 128 139 140 127 128 127 128 127 128 127 125 125 
125 125 125 125 125 125 126 126 125 125 125 125 125 125 125 125 125 125 125 125 125 125 126 126 125 125 125 125 125 125 125 125 
131 132 131 132 131 132 131 132 125 125 125 125 125 125 125 125 131 132 131 132 131 132 131 132 125 125 125 125 125 125 125 125 
129 130 129 130 129 130 129 130 125 125 125 125 125 125 125 125 129 130 129 130 129 130 129 130 125 125 125 125 125 125 125 125 
128 127 128 127 128 127 128 127 125 125 125 125 125 125 125 125 128 127 128 127 128 127 128 127 125 125 125 125 125 125 125 125 
125 125 125 125 125 125 125 125 125 125 125 125 125 125 125 125 126 126 125 125 125 125 125 125 125 125 125 125 125 125 125 125 
125 125 125 125 125 125 125 125 131 132 131 132 131 135 136 132 131 132 131 132 131 132 131 132 125 125 125 125 125 125 125 125 
125 125 125 125 125 125 125 125 129 130 129 130 129 137 138 130 129 130 129 130 129 130 129 130 125 125 125 125 125 125 125 125 
125 125 125 125 125 125 125 125 128 127 128 127 128 139 140 127 128 127 128 127 128 127 128 127 125 125 125 125 125 125 125 125 
125 125 125 125 125 125 125 125 125 125 125 125 125 125 125 125 125 125 125 125 125 125 125 125 125 125 125 125 125 125 125 125 

13 
LADDER 32 128 3 0
LADDER 448 128 3 0
LADDER 352 192 3 0
LADDER 256 256 3 0
LADDER 96 192 3 0
LADDER 384 64 3 0
TOMB 336 272
ENEMY REDJUMPER 128 16
ENEMY REDVENT 64 128
ENEMY REDVENT 416 64
ENEMY REDVENT 224 128
ENEMY REDVENT 288 192
WITEM 160 16 0
