32 20
125 125 127 128 127 128 127 128 127 128 127 128 127 128 127 128 127 128 127 128 127 128 127 128 127 128 127 128 127 128 125 125 
125 125 129 130 129 130 129 130 129 130 129 130 129 130 129 130 129 130 129 130 129 130 129 130 129 130 129 130 129 130 125 125 
125 125 128 127 128 127 128 127 128 127 128 127 128 127 128 127 128 127 128 127 128 127 128 127 128 127 128 127 128 127 125 125 
125 125 125 125 125 125 126 126 130 129 130 129 125 125 125 125 125 125 125 125 130 129 130 129 126 126 125 125 125 125 125 125 
125 125 131 132 131 132 131 132 127 128 127 128 131 132 131 132 131 132 131 132 127 128 127 128 131 132 131 132 131 132 125 125 
125 125 129 130 129 130 129 130 129 130 129 130 129 130 129 130 129 130 129 130 129 130 129 130 129 130 129 130 129 130 125 125 
125 125 128 127 128 127 128 127 128 127 128 127 128 127 128 127 128 127 128 127 128 127 128 127 128 127 128 127 128 127 125 125 
125 125 130 129 125 125 125 125 125 125 125 125 130 129 130 129 130 129 130 129 125 125 125 125 125 125 125 125 130 129 125 125 
125 125 127 128 131 132 131 132 131 132 131 132 127 128 127 128 127 128 127 128 131 132 131 132 131 135 136 132 127 128 125 125 
125 125 129 130 129 130 129 130 129 130 129 130 129 130 129 130 129 130 129 130 129 130 129 130 129 137 138 130 129 130 125 125 
125 125 128 127 128 127 128 127 128 127 128 127 128 127 128 127 128 127 128 127 128 127 128 127 128 139 140 127 128 127 125 125 
125 125 130 129 130 129 130 129 125 125 125 125 125 125 126 126 125 125 125 125 125 125 125 125 125 125 126 126 130 129 125 125 
125 125 127 128 127 128 127 128 131 135 136 132 131 132 131 132 131 132 131 132 131 135 136 132 131 132 131 132 127 128 125 125 
125 125 129 130 129 130 129 130 129 137 138 130 129 130 129 130 129 130 129 130 129 137 138 130 129 130 129 130 129 130 125 125 
125 125 128 127 128 127 128 127 128 139 140 127 128 127 128 127 128 127 128 127 128 139 140 127 128 127 128 127 128 127 125 125 
125 125 130 129 125 125 125 125 125 125 125 125 125 125 125 125 125 125 125 125 125 125 125 125 130 129 130 129 130 129 125 125 
125 125 127 128 131 135 136 132 131 132 131 132 131 132 131 132 131 135 136 132 131 132 131 132 127 128 127 128 127 128 125 125 
125 125 129 130 129 137 138 130 129 130 129 130 129 130 129 130 129 137 138 130 129 130 129 130 129 130 129 130 129 130 125 125 
125 125 128 127 128 139 140 127 128 127 128 127 128 127 128 127 128 139 140 127 128 127 128 127 128 127 128 127 128 127 125 125 
125 125 125 125 125 125 125 125 125 125 125 125 125 125 125 125 125 125 125 125 125 125 125 125 130 129 130 129 130 129 125 125 

11 
TOMB 208 16
LADDER 96 64 3 0
LADDER 224 192 3 0
LADDER 416 192 9 0
LADDER 384 64 3 0
ENEMY REDJUMPER 256 16
ENEMY REDJUMPER 128 80
ENEMY REDJUMPER 160 144
ENEMY REDJUMPER 352 144
ENEMY REDJUMPER 128 208
ENEMY REDJUMPER 160 272
