32 20
125 125 127 128 127 128 127 128 127 128 127 128 127 128 127 128 127 128 127 128 127 128 127 128 127 128 127 128 127 128 125 125 
125 125 129 130 129 130 129 130 129 130 129 130 129 130 129 130 129 130 129 130 129 130 129 130 129 130 129 130 129 130 125 125 
125 125 128 127 128 127 128 127 128 127 128 127 128 127 128 127 128 127 128 127 128 127 128 127 128 127 128 127 128 127 125 125 
125 125 125 125 125 125 125 125 130 129 125 125 125 125 125 125 130 129 125 125 125 125 130 129 125 125 125 125 125 125 125 125 
125 125 131 132 131 135 136 132 127 128 131 132 131 132 131 132 127 128 131 132 131 132 127 128 131 135 136 132 131 132 125 125 
125 125 129 130 129 137 138 130 129 130 129 130 129 130 129 130 129 130 129 130 129 130 129 130 129 137 138 130 129 130 125 125 
125 125 128 127 128 139 140 127 128 127 128 127 128 127 128 127 128 127 128 127 128 127 128 127 128 139 140 127 128 127 125 125 
125 125 125 125 125 125 125 125 125 125 125 125 130 129 125 125 125 125 130 129 125 125 125 125 125 125 125 125 125 125 125 125 
125 125 131 132 131 132 131 132 131 132 131 132 127 128 131 132 131 132 127 128 131 132 131 132 131 132 131 132 131 132 125 125 
125 125 129 130 129 130 129 130 129 130 129 130 129 130 129 130 129 130 129 130 129 130 129 130 129 130 129 130 129 130 125 125 
125 125 128 127 128 127 128 127 128 127 128 127 128 127 128 127 128 127 128 127 128 127 128 127 128 127 128 127 128 127 125 125 
125 125 126 126 125 125 125 125 130 129 125 125 125 125 125 125 125 125 125 125 130 129 125 125 125 125 125 125 125 125 125 125 
125 125 131 132 131 135 136 132 127 128 131 132 131 132 131 132 131 132 131 132 127 128 131 132 131 135 136 132 131 132 125 125 
125 125 129 130 129 137 138 130 129 130 129 130 129 130 129 130 129 130 129 130 129 130 129 130 129 137 138 130 129 130 125 125 
125 125 128 127 128 139 140 127 128 127 128 127 128 127 128 127 128 127 128 127 128 127 128 127 128 139 140 127 128 127 125 125 
125 125 130 129 125 125 125 125 125 125 125 125 125 125 130 129 130 129 125 125 125 125 125 125 125 125 125 125 125 125 125 125 
125 125 127 128 131 132 131 132 131 135 136 132 131 132 127 128 127 128 131 132 131 135 136 132 131 132 131 132 131 132 125 125 
125 125 129 130 129 130 129 130 129 137 138 130 129 130 129 130 129 130 129 130 129 137 138 130 129 130 129 130 129 130 125 125 
125 125 128 127 128 127 128 127 128 139 140 127 128 127 128 127 128 127 128 127 128 139 140 127 128 127 128 127 128 127 125 125 
125 125 130 129 125 125 125 125 125 125 125 125 125 125 125 125 125 125 125 125 125 125 125 125 125 125 125 125 125 125 125 125 

1 
LADDER 32 192 9 0

DEMONROOM
