32 20
127 128 127 128 127 128 127 128 127 128 127 128 127 128 127 128 127 128 127 128 127 128 127 128 127 128 127 128 127 128 125 125 
129 130 129 130 129 130 129 130 129 130 129 130 129 130 129 130 129 130 129 130 129 130 129 130 129 130 129 130 129 130 125 125 
128 127 128 127 128 127 128 127 128 127 128 127 128 127 128 127 128 127 128 127 128 127 128 127 128 127 128 127 128 127 125 125 
125 125 125 125 125 125 125 125 130 129 130 129 125 125 125 125 125 125 125 125 125 125 125 125 130 129 130 129 125 125 125 125 
131 135 136 132 131 132 131 132 127 128 127 128 131 132 131 132 131 132 131 132 131 135 136 132 127 128 127 128 131 132 125 125 
129 137 138 130 129 130 129 130 129 130 129 130 129 130 129 130 129 130 129 130 129 137 138 130 129 130 129 130 129 130 125 125 
128 139 140 127 128 127 128 127 128 127 128 127 128 127 128 127 128 127 128 127 128 139 140 127 128 127 128 127 128 127 125 125 
125 125 125 125 130 129 130 129 130 129 130 129 130 129 130 129 125 125 125 125 125 125 125 125 125 125 125 125 125 125 125 125 
131 132 131 132 127 128 127 128 127 128 127 128 127 128 127 128 131 135 136 132 131 132 131 132 131 132 131 132 131 132 125 125 
129 130 129 130 129 130 129 130 129 130 129 130 129 130 129 130 129 137 138 130 129 130 129 130 129 130 129 130 129 130 125 125 
128 127 128 127 128 127 128 127 128 127 128 127 128 127 128 127 128 139 140 127 128 127 128 127 128 127 128 127 128 127 125 125 
125 125 125 125 125 125 125 125 125 125 125 125 125 125 125 125 125 125 125 125 125 125 125 125 125 125 125 125 125 125 125 125 
131 132 131 132 131 132 131 132 131 135 136 132 131 132 131 132 131 132 131 132 131 132 131 132 131 135 136 132 131 132 125 125 
129 130 129 130 129 130 129 130 129 137 138 130 129 130 129 130 129 130 129 130 129 130 129 130 129 137 138 130 129 130 125 125 
128 127 128 127 128 127 128 127 128 139 140 127 128 127 128 127 128 127 128 127 128 127 128 127 128 139 140 127 128 127 125 125 
125 125 125 125 125 125 126 126 125 125 125 125 125 125 125 126 126 125 125 125 125 125 125 125 126 126 125 125 125 125 125 125 
131 132 131 132 131 132 131 132 131 132 131 132 131 132 131 132 131 132 131 132 131 132 131 132 131 132 131 132 131 132 125 125 
129 130 129 130 129 130 129 130 129 130 129 130 129 130 129 130 129 130 129 130 129 130 129 130 129 130 129 130 129 130 125 125 
128 127 128 127 128 127 128 127 128 127 128 127 128 127 128 127 128 127 128 127 128 127 128 127 128 127 128 127 128 127 125 125 
130 129 130 129 130 129 130 129 130 129 130 129 130 129 130 129 130 129 130 129 130 129 130 129 130 129 130 129 130 129 125 125 

7 
LADDER 240 256 5 0
LADDER 384 256 5 0
LADDER 96 256 5 0
ENEMY CLOUD 176 144
ENEMY CLOUD 256 144
ENEMY CLOUD 320 112
ENEMY CLOUD 352 160
