32 20
125 125 125 125 125 125 125 125 127 128 127 128 127 128 127 128 127 128 127 128 127 128 127 128 127 128 127 128 125 125 125 125 
125 125 125 125 125 125 125 125 129 130 129 130 129 130 129 130 129 130 129 130 129 130 129 130 129 130 129 130 125 125 125 125 
125 125 125 125 125 125 125 125 128 127 128 127 128 127 128 127 128 127 128 127 128 127 128 127 128 127 128 127 125 125 125 125 
125 125 125 125 125 125 125 125 130 129 130 129 125 125 125 125 125 125 125 125 125 125 125 125 130 129 130 129 125 125 125 125 
125 125 125 125 125 125 125 125 127 128 127 128 131 135 136 132 131 132 131 132 131 135 136 132 127 128 127 128 131 132 131 132 
125 125 125 125 125 125 125 125 129 130 129 130 129 137 138 130 129 130 129 130 129 137 138 130 129 130 129 130 129 130 129 130 
125 125 125 125 125 125 125 125 128 127 128 127 128 139 140 127 128 127 128 127 128 139 140 127 128 127 128 127 128 127 128 127 
125 125 125 125 125 125 125 125 125 125 125 126 126 125 125 125 125 125 125 125 125 125 125 125 125 125 125 125 125 125 125 125 
125 125 125 125 125 125 125 125 131 132 131 132 131 132 131 132 131 132 131 132 131 132 131 132 131 135 136 132 125 125 125 125 
125 125 125 125 125 125 125 125 129 130 129 130 129 130 129 130 129 130 129 130 129 130 129 130 129 137 138 130 125 125 125 125 
125 125 125 125 125 125 125 125 128 127 128 127 128 127 128 127 128 127 128 127 128 127 128 127 128 139 140 127 125 125 125 125 
125 125 125 125 125 125 125 125 125 125 125 126 126 125 125 125 130 129 130 129 125 125 125 125 125 125 125 125 125 125 125 125 
125 125 125 125 125 125 125 125 131 132 131 132 131 132 131 132 127 128 127 128 131 135 136 132 131 132 131 132 125 125 125 125 
125 125 125 125 125 125 125 125 129 130 129 130 129 130 129 130 129 130 129 130 129 137 138 130 129 130 129 130 125 125 125 125 
125 125 125 125 125 125 125 125 128 127 128 127 128 127 128 127 128 127 128 127 128 139 140 127 128 127 128 127 125 125 125 125 
125 125 125 125 125 125 125 125 125 125 125 125 125 125 125 125 125 125 125 125 125 125 125 125 125 125 125 125 125 125 125 125 
125 125 125 125 125 125 125 125 125 125 125 125 125 125 125 125 125 125 125 125 125 125 125 125 125 125 125 125 125 125 125 125 
125 125 125 125 125 125 125 125 125 125 125 125 125 125 125 125 125 125 125 125 125 125 125 125 125 125 125 125 125 125 125 125 
125 125 125 125 125 125 125 125 125 125 125 125 125 125 125 125 125 125 125 125 125 125 125 125 125 125 125 125 125 125 125 125 
125 125 125 125 125 125 125 125 125 125 125 125 125 125 125 125 125 125 125 125 125 125 125 125 125 125 125 125 125 125 125 125 

10 
TOMB 400 208
LADDER 176 128 3 0
LADDER 176 192 3 0
LADDER 288 0 3 0
ENEMY PACMAN 192 16
ENEMY PACMAN 128 80
ENEMY PACMAN 128 208
ENEMY PACMAN 208 144
ENEMY PACMAN 368 144
ENEMY PACMAN 368 208
