32 20
127 128 127 128 127 128 127 128 127 128 127 128 127 128 127 128 127 128 127 128 127 128 127 128 127 128 127 128 127 128 127 128 
129 130 129 130 129 130 129 130 129 130 129 130 129 130 129 130 129 130 129 130 129 130 129 130 129 130 129 130 129 130 129 130 
128 127 128 127 128 127 128 127 128 127 128 127 128 127 128 127 128 127 128 127 128 127 128 127 128 127 128 127 128 127 128 127 
125 125 125 125 125 125 125 125 125 125 125 125 125 125 125 125 130 129 130 129 125 125 125 125 125 125 125 125 125 125 125 125 
125 125 125 125 125 125 125 125 125 125 125 125 125 125 125 125 127 128 127 128 125 125 125 125 125 125 125 125 125 125 125 125 
125 125 125 125 125 125 125 125 125 125 125 125 125 125 125 125 129 130 129 130 125 125 125 125 125 125 125 125 125 125 125 125 
125 125 125 125 125 125 125 125 125 125 125 125 125 125 125 125 128 127 128 127 125 125 125 125 125 125 125 125 125 125 125 125 
125 125 125 125 125 125 125 125 125 125 125 125 125 125 125 125 130 129 130 129 125 125 125 125 125 125 125 125 125 125 125 125 
131 132 131 132 131 135 136 132 131 132 131 132 131 132 131 132 127 128 127 128 131 132 131 132 131 132 131 132 131 132 131 132 
129 130 129 130 129 137 138 130 129 130 129 130 129 130 129 130 129 130 129 130 129 130 129 130 129 130 129 130 129 130 129 130 
128 127 128 127 128 139 140 127 128 127 128 127 128 127 128 127 128 127 128 127 128 127 128 127 128 127 128 127 128 127 128 127 
125 125 125 125 125 125 125 125 126 126 125 125 130 129 130 129 125 125 125 125 130 129 130 129 125 125 125 125 125 125 125 125 
131 135 136 132 131 132 131 132 131 132 131 132 127 128 127 128 131 135 136 132 127 128 127 128 131 132 131 132 131 135 136 132 
129 137 138 130 129 130 129 130 129 130 129 130 129 130 129 130 129 137 138 130 129 130 129 130 129 130 129 130 129 137 138 130 
128 139 140 127 128 127 128 127 128 127 128 127 128 127 128 127 128 139 140 127 128 127 128 127 128 127 128 127 128 139 140 127 
125 125 125 125 130 129 130 129 125 125 126 126 130 129 130 129 125 125 125 125 130 129 130 129 125 125 125 125 125 125 125 125 
125 125 125 125 127 128 127 128 131 132 131 132 127 128 127 128 131 132 131 132 127 128 127 128 125 125 125 125 125 125 125 125 
125 125 125 125 129 130 129 130 129 130 129 130 129 130 129 130 129 130 129 130 129 130 129 130 125 125 125 125 125 125 125 125 
125 125 125 125 128 127 128 127 128 127 128 127 128 127 128 127 128 127 128 127 128 127 128 127 125 125 125 125 125 125 125 125 
125 125 125 125 125 125 125 125 130 129 130 129 125 125 125 125 130 129 130 129 125 125 125 125 125 125 125 125 125 125 125 125 

7 
LADDER 128 192 3 0
LADDER 160 256 5 0
LADDER 192 0 3 0
WKEYDOOR 432 192 1
WKEYDOOR 432 128 1
WNOKEYDOOR2 432 0
ENEMY BAT 256 208

BIRDS
