32 20
125 125 125 125 125 125 125 125 127 128 125 125 125 125 125 125 127 128 127 128 125 125 125 125 125 125 125 125 125 125 125 125 
125 125 125 125 125 125 125 125 129 130 125 125 125 125 125 125 129 130 129 130 125 125 125 125 125 125 125 125 125 125 125 125 
125 125 125 125 125 125 125 125 128 127 125 125 125 125 125 125 128 127 128 127 125 125 125 125 125 125 125 125 125 125 125 125 
125 125 125 125 125 125 125 125 130 129 125 125 125 125 125 125 130 129 130 129 125 125 125 125 125 125 125 125 125 125 125 125 
125 125 125 125 125 125 125 125 127 128 125 125 125 125 125 125 127 128 127 128 125 125 125 125 125 125 125 125 125 125 125 125 
125 125 125 125 125 125 125 125 129 130 125 125 125 125 125 125 129 130 129 130 125 125 125 125 125 125 125 125 125 125 125 125 
125 125 125 125 125 125 125 125 128 127 125 125 125 125 125 125 128 127 128 127 125 125 125 125 125 125 125 125 125 125 125 125 
125 125 125 125 125 125 125 125 126 126 125 125 125 125 125 125 130 129 130 129 125 125 125 125 125 125 125 125 125 125 125 125 
125 125 131 132 131 132 131 132 131 132 131 132 131 135 136 132 127 128 127 128 131 132 131 132 131 132 131 132 131 132 125 125 
125 125 129 130 129 130 129 130 129 130 129 130 129 137 138 130 129 130 129 130 129 130 129 130 129 130 129 130 129 130 125 125 
125 125 128 127 128 127 128 127 128 127 128 127 128 139 140 127 128 127 128 127 128 127 128 127 128 127 128 127 128 127 125 125 
125 125 125 125 125 125 125 125 125 125 125 126 126 125 125 125 125 125 125 125 125 125 125 125 130 129 130 129 130 129 125 125 
125 125 131 132 131 132 131 132 131 132 131 132 131 132 131 132 131 135 136 132 131 132 131 132 127 128 127 128 127 128 125 125 
125 125 129 130 129 130 129 130 129 130 129 130 129 130 129 130 129 137 138 130 129 130 129 130 129 130 129 130 129 130 125 125 
125 125 128 127 128 127 128 127 128 127 128 127 128 127 128 127 128 139 140 127 128 127 128 127 128 127 128 127 128 127 125 125 
125 125 130 129 130 129 130 129 126 126 125 125 125 125 125 125 126 126 125 125 130 129 130 129 130 129 130 129 130 129 125 125 
125 125 127 128 127 128 127 128 131 132 131 132 131 132 131 132 131 132 131 132 127 128 127 128 127 128 127 128 127 128 125 125 
125 125 129 130 129 130 129 130 129 130 129 130 129 130 129 130 129 130 129 130 129 130 129 130 129 130 129 130 129 130 125 125 
125 125 128 127 128 127 128 127 128 127 128 127 128 127 128 127 128 127 128 127 128 127 128 127 128 127 128 127 128 127 125 125 
125 125 125 125 125 125 125 125 125 125 125 125 130 129 130 129 130 129 130 129 125 125 125 125 125 125 125 125 125 125 125 125 

6 
LADDER 128 0 7 0
LADDER 128 128 3 0
LADDER 128 256 3 0
LADDER 176 192 3 0
LADDER 256 256 5 0
TOMB 336 144

BIRDS2 