32 20
125 125 127 128 127 128 127 128 127 128 127 128 127 128 127 128 127 128 127 128 127 128 127 128 127 128 127 128 127 128 127 128 
125 125 129 130 129 130 129 130 129 130 129 130 129 130 129 130 129 130 129 130 129 130 129 130 129 130 129 130 129 130 129 130 
125 125 128 127 128 127 128 127 128 127 128 127 128 127 128 127 128 127 128 127 128 127 128 127 128 127 128 127 128 127 128 127 
125 125 130 129 130 129 130 129 125 125 125 125 125 125 125 125 126 126 125 125 125 125 125 125 125 125 125 125 125 125 125 125 
125 125 127 128 127 128 127 128 131 132 131 132 131 132 131 132 131 132 131 132 131 132 131 132 131 135 136 132 131 132 125 125 
125 125 129 130 129 130 129 130 129 130 129 130 129 130 129 130 129 130 129 130 129 130 129 130 129 137 138 130 129 130 125 125 
125 125 128 127 128 127 128 127 128 127 128 127 128 127 128 127 128 127 128 127 128 127 128 127 128 139 140 127 128 127 125 125 
125 125 125 125 125 125 130 129 130 129 130 129 125 125 125 125 125 125 125 125 130 129 130 129 125 125 126 126 130 129 125 125 
131 135 136 132 131 132 127 128 127 128 127 128 131 135 136 132 131 132 131 132 127 128 127 128 131 132 131 132 127 128 125 125 
129 137 138 130 129 130 129 130 129 130 129 130 129 137 138 130 129 130 129 130 129 130 129 130 129 130 129 130 129 130 125 125 
128 139 140 127 128 127 128 127 128 127 128 127 128 139 140 127 128 127 128 127 128 127 128 127 128 127 128 127 128 127 125 125 
125 125 125 125 125 125 125 125 125 125 125 125 126 126 125 125 130 129 130 129 125 125 126 126 125 125 125 125 125 125 125 125 
125 125 125 125 125 125 125 125 131 132 131 132 131 132 131 132 127 128 127 128 131 132 131 132 131 132 131 132 131 132 125 125 
125 125 125 125 125 125 125 125 129 130 129 130 129 130 129 130 129 130 129 130 129 130 129 130 129 130 129 130 129 130 125 125 
125 125 125 125 125 125 125 125 128 127 128 127 128 127 128 127 128 127 128 127 128 127 128 127 128 127 128 127 128 127 125 125 
125 125 125 125 125 125 125 125 130 129 130 129 125 125 125 125 125 125 126 126 125 125 125 125 125 125 125 125 130 129 125 125 
131 132 131 132 125 125 125 125 127 128 127 128 131 135 136 132 131 132 131 132 131 132 131 132 131 135 136 132 127 128 125 125 
129 130 129 130 125 125 125 125 129 130 129 130 129 137 138 130 129 130 129 130 129 130 129 130 129 137 138 130 129 130 125 125 
128 127 128 127 125 125 125 125 128 127 128 127 128 139 140 127 128 127 128 127 128 127 128 127 128 139 140 127 128 127 125 125 
125 125 125 125 125 125 125 125 125 125 125 125 125 125 125 125 125 125 125 125 125 125 125 125 125 125 125 125 125 125 125 125 

10 
LADDER 192 192 3 0
LADDER 352 192 3 0
LADDER 288 256 3 0
LADDER 416 128 3 0
LADDER 256 64 3 0
TOMB 144 16
WNOKEYDOOR3 80 128
ENEMY GREENMONKEY 256 80
ENEMY GREENMONKEY 320 16
ENEMY GREENMONKEY 320 208
