32 20
127 128 127 128 127 128 127 128 127 128 127 128 127 128 125 125 125 125 127 128 127 128 125 125 125 125 125 125 125 125 125 125 
129 130 129 130 129 130 129 130 129 130 129 130 129 130 125 125 125 125 129 130 129 130 125 125 125 125 125 125 125 125 125 125 
128 127 128 127 128 127 128 127 128 127 128 127 128 127 125 125 125 125 128 127 128 127 125 125 125 125 125 125 125 125 125 125 
125 125 125 125 125 125 125 125 125 125 125 125 125 125 125 125 125 125 130 129 130 129 125 125 125 125 125 125 125 125 125 125 
125 125 125 125 131 132 131 132 131 135 136 132 131 132 131 132 131 132 127 128 127 128 125 125 131 132 131 132 131 132 131 132 
125 125 125 125 129 130 129 130 129 137 138 130 129 130 129 130 129 130 129 130 129 130 125 125 129 130 129 130 129 130 129 130 
125 125 125 125 128 127 128 127 128 139 140 127 128 127 128 127 128 127 128 127 128 127 125 125 128 127 128 127 128 127 128 127 
125 125 125 125 125 125 125 125 125 125 125 125 130 129 130 129 125 125 125 125 125 125 125 125 130 129 130 129 130 129 130 129 
125 125 125 125 131 135 136 132 131 132 131 132 127 128 127 128 131 135 136 132 131 132 131 132 127 128 127 128 127 128 127 128 
125 125 125 125 129 137 138 130 129 130 129 130 129 130 129 130 129 137 138 130 129 130 129 130 129 130 129 130 129 130 129 130 
125 125 125 125 128 139 140 127 128 127 128 127 128 127 128 127 128 139 140 127 128 127 128 127 128 127 128 127 128 127 128 127 
125 125 125 125 125 125 125 125 125 125 125 125 125 125 125 125 125 125 125 125 125 125 125 125 130 129 130 129 125 125 125 125 
125 125 125 125 131 132 131 132 131 135 136 132 131 132 131 132 131 132 131 132 131 135 136 132 127 128 127 128 131 132 125 125 
125 125 125 125 129 130 129 130 129 137 138 130 129 130 129 130 129 130 129 130 129 137 138 130 129 130 129 130 129 130 125 125 
125 125 125 125 128 127 128 127 128 139 140 127 128 127 128 127 128 127 128 127 128 139 140 127 128 127 128 127 128 127 125 125 
125 125 125 125 130 129 130 129 125 125 125 125 125 125 125 125 125 125 125 125 125 125 125 125 125 125 125 125 125 125 125 125 
131 132 131 132 127 128 127 128 131 132 131 132 131 135 136 132 131 132 131 132 131 132 131 132 131 135 136 132 131 132 125 125 
129 130 129 130 129 130 129 130 129 130 129 130 129 137 138 130 129 130 129 130 129 130 129 130 129 137 138 130 129 130 125 125 
128 127 128 127 128 127 128 127 128 127 128 127 128 139 140 127 128 127 128 127 128 127 128 127 128 139 140 127 128 127 125 125 
125 125 125 125 125 125 125 125 125 125 125 125 125 125 125 125 125 125 125 125 125 125 125 125 125 125 125 125 125 125 125 125 

11 
TOMB 80 16
WNOKEYDOOR 128 128
WNOKEYDOOR 224 192
WNOKEYDOOR 368 256
WNOKEYDOOR 320 128
ENEMY BAT 128 64
ENEMY BAT 288 128
ENEMY BAT 192 192
ENEMY BAT 352 256
ENEMY WHITEFIREBALL 320 208
ENEMY WHITEFIREBALL 128 80
