32 20
125 125 127 128 127 128 127 128 127 128 127 128 127 128 127 128 127 128 127 128 127 128 127 128 127 128 127 128 127 128 125 125 
125 125 129 130 129 130 129 130 129 130 129 130 129 130 129 130 129 130 129 130 129 130 129 130 129 130 129 130 129 130 125 125 
125 125 128 127 128 127 128 127 128 127 128 127 128 127 128 127 128 127 128 127 128 127 128 127 128 127 128 127 128 127 125 125 
125 125 130 129 130 129 130 129 130 129 130 129 125 125 125 125 125 125 125 125 130 129 130 129 130 129 130 129 130 129 125 125 
125 125 127 128 127 128 127 128 127 128 127 128 131 135 136 132 131 135 136 132 127 128 127 128 127 128 127 128 127 128 125 125 
125 125 129 130 129 130 129 130 129 130 129 130 129 137 138 130 129 137 138 130 129 130 129 130 129 130 129 130 129 130 125 125 
125 125 128 127 128 127 128 127 128 127 128 127 128 139 140 127 128 139 140 127 128 127 128 127 128 127 128 127 128 127 125 125 
125 125 125 125 125 125 126 126 125 125 125 125 126 126 125 125 125 125 126 126 125 125 125 125 126 126 125 125 125 125 125 125 
125 125 125 125 125 125 131 132 125 125 125 125 131 132 131 132 131 132 131 132 125 125 125 125 131 132 125 125 125 125 125 125 
125 125 125 125 125 125 129 130 125 125 125 125 129 130 129 130 129 130 129 130 125 125 125 125 129 130 125 125 125 125 125 125 
125 125 125 125 125 125 128 127 125 125 125 125 128 127 128 127 128 127 128 127 125 125 125 125 128 127 125 125 125 125 125 125 
125 125 125 125 125 125 126 126 125 125 125 125 126 126 125 125 125 125 126 126 125 125 125 125 126 126 125 125 125 125 125 125 
125 125 125 125 125 125 131 132 131 132 131 132 131 132 125 125 125 125 131 132 131 132 131 132 131 132 125 125 125 125 125 125 
125 125 125 125 125 125 129 130 129 130 129 130 129 130 125 125 125 125 129 130 129 130 129 130 129 130 125 125 125 125 125 125 
125 125 125 125 125 125 128 127 128 127 128 127 128 127 125 125 125 125 128 127 128 127 128 127 128 127 125 125 125 125 125 125 
125 125 125 125 125 125 126 126 125 125 125 125 126 126 125 125 125 125 126 126 125 125 125 125 126 126 125 125 125 125 125 125 
125 125 131 132 131 132 131 132 125 125 125 125 131 132 131 132 131 132 131 132 131 132 131 132 131 132 131 132 131 132 125 125 
125 125 129 130 129 130 129 130 125 125 125 125 129 130 129 130 129 130 129 130 129 130 129 130 129 130 129 130 129 130 125 125 
125 125 128 127 128 127 128 127 125 125 125 125 128 127 128 127 128 127 128 127 128 127 128 127 128 127 128 127 128 127 125 125 
125 125 125 125 125 125 125 125 125 125 125 125 125 125 125 125 125 125 125 125 130 129 130 129 125 125 125 125 125 125 125 125 

13 
LADDER 240 0 3 0
LADDER 96 128 3 0
LADDER 96 192 3 0
LADDER 96 256 3 0
LADDER 192 256 3 0
LADDER 192 192 3 0
LADDER 192 128 3 0
LADDER 288 128 3 0
LADDER 288 192 3 0
LADDER 288 256 3 0
LADDER 384 256 3 0
LADDER 384 192 3 0
LADDER 384 128 3 0
