32 20
127 128 127 128 127 128 127 128 127 128 127 128 127 128 127 128 127 128 127 128 127 128 127 128 125 125 125 125 125 125 125 125 
129 130 129 130 129 130 129 130 129 130 129 130 129 130 129 130 129 130 129 130 129 130 129 130 125 125 125 125 125 125 125 125 
128 127 128 127 128 127 128 127 128 127 128 127 128 127 128 127 128 127 128 127 128 127 128 127 125 125 125 125 125 125 125 125 
125 125 125 125 125 125 125 125 130 129 130 129 125 125 125 125 130 129 130 129 130 129 130 129 125 125 125 125 125 125 125 125 
131 132 131 132 131 135 136 132 127 128 127 128 131 132 131 132 127 128 127 128 127 128 127 128 131 135 136 132 131 132 131 132 
129 130 129 130 129 137 138 130 129 130 129 130 129 130 129 130 129 130 129 130 129 130 129 130 129 137 138 130 129 130 129 130 
128 127 128 127 128 139 140 127 128 127 128 127 128 127 128 127 128 127 128 127 128 127 128 127 128 139 140 127 128 127 128 127 
125 125 125 125 125 125 125 125 130 129 125 125 125 125 125 125 125 125 125 125 125 125 130 129 125 125 125 125 125 125 125 125 
131 132 131 132 131 132 131 132 127 128 131 132 131 132 131 132 131 132 131 132 131 132 127 128 131 132 131 132 131 132 131 132 
129 130 129 130 129 130 129 130 129 130 129 130 129 130 129 130 129 130 129 130 129 130 129 130 129 130 129 130 129 130 129 130 
128 127 128 127 128 127 128 127 128 127 128 127 128 127 128 127 128 127 128 127 128 127 128 127 128 127 128 127 128 127 128 127 
130 129 130 129 130 129 130 129 130 129 130 129 130 129 130 129 130 129 130 129 130 129 130 129 130 129 130 129 130 129 130 129 
163 163 163 163 163 163 163 163 163 163 163 163 163 163 163 163 163 163 163 163 163 163 163 163 163 163 163 163 163 163 163 163 
164 164 164 164 164 164 164 164 164 164 164 164 164 164 164 164 164 164 164 164 164 164 164 164 164 164 164 164 164 164 164 164 
164 164 164 164 164 164 164 164 164 164 164 164 164 164 164 164 164 164 164 164 164 164 164 164 164 164 164 164 164 164 164 164 
164 164 164 164 164 164 164 164 164 164 164 164 164 164 164 164 164 164 164 164 164 164 164 164 164 164 164 164 164 164 164 164 
164 164 164 164 164 164 164 164 164 164 164 164 164 164 164 164 164 164 164 164 164 164 164 164 164 164 164 164 164 164 164 164 
164 164 164 164 164 164 164 164 164 164 164 164 164 164 164 164 164 164 164 164 164 164 164 164 164 164 164 164 164 164 164 164 
164 164 164 164 164 164 164 164 164 164 164 164 164 164 164 164 164 164 164 164 164 164 164 164 164 164 164 164 164 164 164 164 
165 165 165 165 165 165 165 165 165 165 165 165 165 165 165 165 165 165 165 165 165 165 165 165 165 165 165 165 165 165 165 165 

1 
TOMB 208 80
