32 20
125 125 125 125 125 125 125 125 125 125 125 125 125 125 127 128 127 128 125 125 125 125 125 125 127 128 127 128 125 125 125 125 
125 125 125 125 125 125 125 125 125 125 125 125 125 125 129 130 129 130 125 125 125 125 125 125 129 130 129 130 125 125 125 125 
125 125 125 125 125 125 125 125 125 125 125 125 125 125 128 127 128 127 125 125 125 125 125 125 128 127 128 127 125 125 125 125 
125 125 125 125 125 125 125 125 125 125 125 125 125 125 130 129 130 129 125 125 125 125 125 125 125 125 126 126 125 125 125 125 
131 135 136 132 131 132 131 132 131 135 136 132 131 132 127 128 127 128 131 132 131 135 136 132 131 132 131 132 125 125 125 125 
129 137 138 130 129 130 129 130 129 137 138 130 129 130 129 130 129 130 129 130 129 137 138 130 129 130 129 130 125 125 125 125 
128 139 140 127 128 127 128 127 128 139 140 127 128 127 128 127 128 127 128 127 128 139 140 127 128 127 128 127 125 125 125 125 
125 125 125 125 130 129 130 129 125 125 125 125 125 125 130 129 130 129 125 125 125 125 125 125 125 125 125 125 125 125 125 125 
125 125 131 132 127 128 127 128 131 132 131 132 131 132 127 128 127 128 131 132 131 132 131 132 131 135 136 132 131 132 125 125 
125 125 129 130 129 130 129 130 129 130 129 130 129 130 129 130 129 130 129 130 129 130 129 130 129 137 138 130 129 130 125 125 
125 125 128 127 128 127 128 127 128 127 128 127 128 127 128 127 128 127 128 127 128 127 128 127 128 139 140 127 128 127 125 125 
125 125 125 125 125 125 125 125 130 129 125 125 125 125 130 129 130 129 125 125 125 125 125 125 125 125 125 125 125 125 125 125 
125 125 131 132 131 132 131 132 127 128 131 132 131 132 127 128 127 128 131 132 131 135 136 132 131 132 131 132 131 132 125 125 
125 125 129 130 129 130 129 130 129 130 129 130 129 130 129 130 129 130 129 130 129 137 138 130 129 130 129 130 129 130 125 125 
125 125 128 127 128 127 128 127 128 127 128 127 128 127 128 127 128 127 128 127 128 139 140 127 128 127 128 127 128 127 125 125 
125 125 125 125 125 125 125 125 125 125 125 125 125 125 130 129 130 129 125 125 125 125 126 126 125 125 125 125 125 125 125 125 
125 125 125 125 125 125 125 125 125 125 125 125 125 125 127 128 127 128 125 125 125 125 131 132 125 125 125 125 125 125 125 125 
125 125 125 125 125 125 125 125 125 125 125 125 125 125 129 130 129 130 125 125 125 125 129 130 125 125 125 125 125 125 125 125 
125 125 125 125 125 125 125 125 125 125 125 125 125 125 128 127 128 127 125 125 125 125 128 127 125 125 125 125 125 125 125 125 
125 125 125 125 125 125 125 125 125 125 125 125 125 125 130 129 130 129 125 125 125 125 130 129 125 125 125 125 125 125 125 125 

8 
TOMB 80 208
LADDER 416 0 3 0
LADDER 416 64 3 0
LADDER 352 256 5 0
ENEMY TRANSFORMER 128 80
ENEMY TRANSFORMER 64 144
ENEMY TRANSFORMER 160 208
ENEMY TRANSFORMER 320 144
