32 20
127 128 127 128 127 128 127 128 125 125 125 125 125 125 125 125 125 125 125 125 127 128 127 128 125 125 125 125 125 125 125 125 
129 130 129 130 129 130 129 130 125 125 125 125 125 125 125 125 125 125 125 125 129 130 129 130 125 125 125 125 125 125 125 125 
128 127 128 127 128 127 128 127 125 125 125 125 125 125 125 125 125 125 125 125 128 127 128 127 125 125 125 125 125 125 125 125 
125 125 125 125 125 125 130 129 125 125 125 125 125 125 125 125 125 125 125 125 125 125 126 126 125 125 125 125 125 125 125 125 
131 135 136 132 131 132 127 128 131 132 131 132 131 132 131 132 131 132 131 132 131 132 131 132 131 132 131 132 131 135 136 132 
129 137 138 130 129 130 129 130 129 130 129 130 129 130 129 130 129 130 129 130 129 130 129 130 129 130 129 130 129 137 138 130 
128 139 140 127 128 127 128 127 128 127 128 127 128 127 128 127 128 127 128 127 128 127 128 127 128 127 128 127 128 139 140 127 
125 125 125 125 125 125 130 129 125 125 125 125 125 125 126 126 130 129 130 129 125 125 125 125 130 129 130 129 125 125 125 125 
125 125 131 132 131 132 127 128 131 135 136 132 131 132 131 132 127 128 127 128 125 125 125 125 127 128 127 128 125 125 125 125 
125 125 129 130 129 130 129 130 129 137 138 130 129 130 129 130 129 130 129 130 125 125 125 125 129 130 129 130 125 125 125 125 
125 125 128 127 128 127 128 127 128 139 140 127 128 127 128 127 128 127 128 127 125 125 125 125 128 127 128 127 125 125 125 125 
125 125 125 125 125 125 130 129 125 125 125 125 125 125 126 126 130 129 130 129 125 125 125 125 130 129 130 129 125 125 125 125 
125 125 125 125 125 125 127 128 131 135 136 132 131 132 131 132 127 128 127 128 125 125 125 125 127 128 127 128 125 125 125 125 
125 125 125 125 125 125 129 130 129 137 138 130 129 130 129 130 129 130 129 130 125 125 125 125 129 130 129 130 125 125 125 125 
125 125 125 125 125 125 128 127 128 139 140 127 128 127 128 127 128 127 128 127 125 125 125 125 128 127 128 127 125 125 125 125 
125 125 125 125 125 125 130 129 125 125 125 125 125 125 126 126 130 129 130 129 125 125 125 125 130 129 130 129 125 125 125 125 
125 125 131 132 131 132 127 128 131 132 131 132 131 132 131 132 127 128 127 128 125 125 125 125 127 128 127 128 131 135 136 132 
125 125 129 130 129 130 129 130 129 130 129 130 129 130 129 130 129 130 129 130 125 125 125 125 129 130 129 130 129 137 138 130 
125 125 128 127 128 127 128 127 128 127 128 127 128 127 128 127 128 127 128 127 125 125 125 125 128 127 128 127 128 139 140 127 
125 125 125 125 125 125 130 129 125 125 125 125 125 125 125 125 125 125 125 125 125 125 125 125 130 129 125 125 125 125 125 125 

9 
LADDER 320 0 3 0
LADDER 352 64 3 0
LADDER 224 128 3 0
LADDER 224 192 3 0
LADDER 224 256 3 0
TOMB 208 80
ENEMY WITCH2 128 64 0
ENEMY WITCH2 288 64 0
ENEMY WITCH2 448 272 1
