32 20
125 125 127 128 127 128 127 128 127 128 127 128 127 128 127 128 127 128 125 125 127 128 127 128 125 125 127 128 127 128 125 125 
125 125 129 130 129 130 129 130 129 130 129 130 129 130 129 130 129 130 125 125 129 130 129 130 125 125 129 130 129 130 125 125 
125 125 128 127 128 127 128 127 128 127 128 127 128 127 128 127 128 127 125 125 128 127 128 127 125 125 128 127 128 127 125 125 
125 125 125 125 125 125 130 129 125 125 125 125 130 129 130 129 125 125 125 125 130 129 130 129 125 125 130 129 130 129 125 125 
125 125 131 132 131 132 127 128 125 125 131 132 127 128 127 128 131 132 125 125 127 128 127 128 131 132 127 128 127 128 125 125 
125 125 129 130 129 130 129 130 125 125 129 130 129 130 129 130 129 130 125 125 129 130 129 130 129 130 129 130 129 130 125 125 
125 125 128 127 128 127 128 127 125 125 128 127 128 127 128 127 128 127 125 125 128 127 128 127 128 127 128 127 128 127 125 125 
125 125 125 125 125 125 125 125 125 125 130 129 125 125 125 125 130 129 125 125 125 125 125 125 125 125 125 125 130 129 125 125 
125 125 131 132 131 132 131 132 131 132 127 128 131 132 125 125 127 128 131 132 131 132 125 125 131 132 131 132 127 128 125 125 
125 125 129 130 129 130 129 130 129 130 129 130 129 130 125 125 129 130 129 130 129 130 125 125 129 130 129 130 129 130 125 125 
125 125 128 127 128 127 128 127 128 127 128 127 128 127 125 125 128 127 128 127 128 127 125 125 128 127 128 127 128 127 125 125 
125 125 130 129 125 125 125 125 130 129 125 125 125 125 125 125 125 125 125 125 130 129 125 125 125 125 125 125 125 125 125 125 
125 125 127 128 131 132 125 125 127 128 125 125 131 132 131 132 131 135 136 132 127 128 125 125 131 135 136 132 131 132 125 125 
125 125 129 130 129 130 125 125 129 130 125 125 129 130 129 130 129 137 138 130 129 130 125 125 129 137 138 130 129 130 125 125 
125 125 128 127 128 127 125 125 128 127 125 125 128 127 128 127 128 139 140 127 128 127 125 125 128 139 140 127 128 127 125 125 
125 125 125 125 125 125 125 125 130 129 125 125 125 125 130 129 125 125 125 125 125 125 125 125 125 125 125 125 130 129 125 125 
125 125 131 132 131 135 136 132 127 128 131 132 131 132 127 128 131 132 131 132 131 132 131 132 131 132 131 132 127 128 125 125 
125 125 129 130 129 137 138 130 129 130 129 130 129 130 129 130 129 130 129 130 129 130 129 130 129 130 129 130 129 130 125 125 
125 125 128 127 128 139 140 127 128 127 128 127 128 127 128 127 128 127 128 127 128 127 128 127 128 127 128 127 128 127 125 125 
125 125 130 129 125 125 125 125 125 125 125 125 130 129 125 125 130 129 125 125 125 125 125 125 130 129 130 129 125 125 125 125 

8 
LADDER 320 0 7 0
LADDER 160 0 3 0
WKEYDOOR 96 128 1
WKEYDOOR 320 256 1
TOMB 400 144
ENEMY SNAKE 352 80
ENEMY SNAKE 256 208
ENEMY SNAKE 96 272
