32 20
125 125 127 128 127 128 127 128 127 128 127 128 125 125 127 128 127 128 127 128 127 128 127 128 127 128 127 128 127 128 127 128 
125 125 129 130 129 130 129 130 129 130 129 130 125 125 129 130 129 130 129 130 129 130 129 130 129 130 129 130 129 130 129 130 
125 125 128 127 128 127 128 127 128 127 128 127 125 125 128 127 128 127 128 127 128 127 128 127 128 127 128 127 128 127 128 127 
125 125 125 125 125 125 125 125 130 129 130 129 125 125 125 125 125 125 125 125 130 129 125 125 125 125 125 125 125 125 125 125 
125 125 131 132 131 135 136 132 127 128 127 128 131 132 131 132 131 135 136 132 127 128 125 125 131 132 131 132 131 135 136 132 
125 125 129 130 129 137 138 130 129 130 129 130 129 130 129 130 129 137 138 130 129 130 125 125 129 130 129 130 129 137 138 130 
125 125 128 127 128 139 140 127 128 127 128 127 128 127 128 127 128 139 140 127 128 127 125 125 128 127 128 127 128 139 140 127 
125 125 130 129 125 125 125 125 125 125 130 129 130 129 125 125 125 125 125 125 125 125 125 125 130 129 130 129 125 125 125 125 
125 125 127 128 131 132 131 132 125 125 127 128 127 128 131 132 125 125 131 132 131 132 131 132 127 128 127 128 131 132 125 125 
125 125 129 130 129 130 129 130 125 125 129 130 129 130 129 130 125 125 129 130 129 130 129 130 129 130 129 130 129 130 125 125 
125 125 128 127 128 127 128 127 125 125 128 127 128 127 128 127 125 125 128 127 128 127 128 127 128 127 128 127 128 127 125 125 
125 125 125 125 125 125 130 129 125 125 125 125 130 129 130 129 125 125 125 125 130 129 130 129 125 125 130 129 130 129 125 125 
125 125 131 132 131 132 127 128 125 125 131 132 127 128 127 128 131 135 136 132 127 128 127 128 131 132 127 128 127 128 125 125 
125 125 129 130 129 130 129 130 125 125 129 130 129 130 129 130 129 137 138 130 129 130 129 130 129 130 129 130 129 130 125 125 
125 125 128 127 128 127 128 127 125 125 128 127 128 127 128 127 128 139 140 127 128 127 128 127 128 127 128 127 128 127 125 125 
125 125 125 125 125 125 125 125 125 125 130 129 125 125 125 125 125 125 125 125 125 125 125 125 130 129 125 125 125 125 125 125 
131 135 136 132 131 132 131 132 131 132 127 128 131 135 136 132 131 132 131 132 131 132 125 125 127 128 131 132 131 132 125 125 
129 137 138 130 129 130 129 130 129 130 129 130 129 137 138 130 129 130 129 130 129 130 125 125 129 130 129 130 129 130 125 125 
128 139 140 127 128 127 128 127 128 127 128 127 128 139 140 127 128 127 128 127 128 127 125 125 128 127 128 127 128 127 125 125 
125 125 125 125 125 125 125 125 125 125 125 125 125 125 125 125 125 125 125 125 125 125 125 125 125 125 125 125 125 125 125 125 

7 
WNOKEYDOOR2 128 256
TOMB 80 16
ENEMY GORILLA 96 80
ENEMY GORILLA 224 80
ENEMY GORILLA 192 272
ENEMY GORILLA 288 208
ENEMY GORILLA 384 16
