32 20
125 125 125 125 125 125 127 128 127 128 127 128 127 128 127 128 127 128 127 128 127 128 127 128 127 128 127 128 127 128 125 125 
125 125 125 125 125 125 129 130 129 130 129 130 129 130 129 130 129 130 129 130 129 130 129 130 129 130 129 130 129 130 125 125 
125 125 125 125 125 125 128 127 128 127 128 127 128 127 128 127 128 127 128 127 128 127 128 127 128 127 128 127 128 127 125 125 
125 125 125 125 125 125 125 125 125 125 125 125 126 126 125 125 125 125 125 125 125 125 125 125 125 125 125 125 125 125 125 125 
125 125 125 125 125 125 131 132 131 132 131 132 131 132 131 132 131 132 131 132 131 132 131 132 131 135 136 132 131 132 125 125 
125 125 125 125 125 125 129 130 129 130 129 130 129 130 129 130 129 130 129 130 129 130 129 130 129 137 138 130 129 130 125 125 
125 125 125 125 125 125 128 127 128 127 128 127 128 127 128 127 128 127 128 127 128 127 128 127 128 139 140 127 128 127 125 125 
125 125 125 125 125 125 130 129 130 129 125 125 125 125 125 125 130 129 130 129 125 125 125 125 125 125 125 125 130 129 125 125 
125 125 125 125 125 125 127 128 127 128 125 125 131 132 131 132 127 128 127 128 131 135 136 132 131 132 131 132 127 128 125 125 
125 125 125 125 125 125 129 130 129 130 125 125 129 130 129 130 129 130 129 130 129 137 138 130 129 130 129 130 129 130 125 125 
125 125 125 125 125 125 128 127 128 127 125 125 128 127 128 127 128 127 128 127 128 139 140 127 128 127 128 127 128 127 125 125 
125 125 125 125 125 125 125 125 130 129 125 125 130 129 130 129 126 126 125 125 125 125 125 125 125 125 126 126 125 125 125 125 
131 135 136 132 131 132 131 132 127 128 125 125 127 128 127 128 131 132 131 132 131 132 131 132 131 132 131 132 131 132 125 125 
129 137 138 130 129 130 129 130 129 130 125 125 129 130 129 130 129 130 129 130 129 130 129 130 129 130 129 130 129 130 125 125 
128 139 140 127 128 127 128 127 128 127 125 125 128 127 128 127 128 127 128 127 128 127 128 127 128 127 128 127 128 127 125 125 
125 125 125 125 125 125 125 125 125 125 125 125 130 129 130 129 126 126 125 125 125 125 125 125 125 125 126 126 125 125 125 125 
125 125 131 132 131 132 131 132 131 132 131 132 127 128 127 128 131 132 131 132 131 135 136 132 131 132 131 132 131 132 125 125 
125 125 129 130 129 130 129 130 129 130 129 130 129 130 129 130 129 130 129 130 129 137 138 130 129 130 129 130 129 130 125 125 
125 125 128 127 128 127 128 127 128 127 128 127 128 127 128 127 128 127 128 127 128 139 140 127 128 127 128 127 128 127 125 125 
125 125 130 129 125 125 125 125 125 125 125 125 125 125 125 125 125 125 125 125 125 125 125 125 125 125 125 125 125 125 125 125 

11 
LADDER 256 256 3 0
LADDER 416 256 3 0
LADDER 416 192 3 0
LADDER 256 192 3 0
LADDER 192 64 3 0
TOMB 336 80
WNOKEYDOOR 112 256
ENEMY LCLOUD 128 16
ENEMY LCLOUD 192 16
ENEMY LCLOUD 256 16
ENEMY LCLOUD 320 16
