32 20
127 128 127 128 127 128 125 125 127 128 127 128 127 128 127 128 127 128 127 128 127 128 125 125 127 128 127 128 127 128 125 125 
129 130 129 130 129 130 125 125 129 130 129 130 129 130 129 130 129 130 129 130 129 130 125 125 129 130 129 130 129 130 125 125 
128 127 128 127 128 127 125 125 128 127 128 127 128 127 128 127 128 127 128 127 128 127 125 125 128 127 128 127 128 127 125 125 
125 125 125 125 130 129 125 125 125 125 130 129 125 125 125 125 125 125 125 125 130 129 125 125 130 129 125 125 125 125 125 125 
131 132 131 132 127 128 131 132 125 125 127 128 131 132 131 132 131 132 125 125 127 128 125 125 127 128 131 132 131 132 125 125 
129 130 129 130 129 130 129 130 125 125 129 130 129 130 129 130 129 130 125 125 129 130 125 125 129 130 129 130 129 130 125 125 
128 127 128 127 128 127 128 127 125 125 128 127 128 127 128 127 128 127 125 125 128 127 125 125 128 127 128 127 128 127 125 125 
125 125 130 129 130 129 130 129 125 125 125 125 130 129 130 129 125 125 125 125 130 129 125 125 125 125 125 125 130 129 125 125 
125 125 127 128 127 128 127 128 131 132 131 132 127 128 127 128 131 132 125 125 127 128 131 132 131 135 136 132 127 128 125 125 
125 125 129 130 129 130 129 130 129 130 129 130 129 130 129 130 129 130 125 125 129 130 129 130 129 137 138 130 129 130 125 125 
125 125 128 127 128 127 128 127 128 127 128 127 128 127 128 127 128 127 125 125 128 127 128 127 128 139 140 127 128 127 125 125 
125 125 130 129 125 125 125 125 125 125 125 125 125 125 125 125 125 125 125 125 125 125 130 129 125 125 125 125 125 125 125 125 
131 132 127 128 125 125 131 132 131 132 131 132 131 132 131 132 125 125 131 132 131 132 127 128 131 132 131 132 131 132 125 125 
129 130 129 130 125 125 129 130 129 130 129 130 129 130 129 130 125 125 129 130 129 130 129 130 129 130 129 130 129 130 125 125 
128 127 128 127 125 125 128 127 128 127 128 127 128 127 128 127 125 125 128 127 128 127 128 127 128 127 128 127 128 127 125 125 
125 125 130 129 125 125 125 125 125 125 125 125 125 125 130 129 125 125 130 129 125 125 125 125 130 129 125 125 130 129 125 125 
125 125 127 128 131 132 131 132 131 132 131 132 131 132 127 128 131 132 127 128 131 132 125 125 127 128 125 125 127 128 125 125 
125 125 129 130 129 130 129 130 129 130 129 130 129 130 129 130 129 130 129 130 129 130 125 125 129 130 125 125 129 130 125 125 
125 125 128 127 128 127 128 127 128 127 128 127 128 127 128 127 128 127 128 127 128 127 125 125 128 127 125 125 128 127 125 125 
125 125 125 125 125 125 125 125 125 125 125 125 125 125 125 125 125 125 125 125 125 125 125 125 125 125 125 125 125 125 125 125 

6 
WNOKEYDOOR 176 128
TOMB 144 272
LADDER 416 0 3 0
ENEMY LCLOUD 96 16
ENEMY LCLOUD 160 16
ENEMY LCLOUD 384 16

