32 20
125 125 127 128 127 128 127 128 127 128 127 128 125 125 125 125 125 125 125 125 127 128 127 128 125 125 125 125 125 125 125 125 
125 125 129 130 129 130 129 130 129 130 129 130 125 125 125 125 125 125 125 125 129 130 129 130 125 125 125 125 125 125 125 125 
125 125 128 127 128 127 128 127 128 127 128 127 125 125 125 125 125 125 125 125 128 127 128 127 125 125 125 125 125 125 125 125 
125 125 130 129 130 129 125 125 125 125 125 125 125 125 125 125 125 125 125 125 130 129 125 125 125 125 125 125 125 125 125 125 
125 125 127 128 127 128 131 132 131 132 131 132 125 125 125 125 125 125 125 125 127 128 131 132 125 125 125 125 125 125 125 125 
125 125 129 130 129 130 129 130 129 130 129 130 125 125 125 125 125 125 125 125 129 130 129 130 125 125 125 125 125 125 125 125 
125 125 128 127 128 127 128 127 128 127 128 127 125 125 125 125 125 125 125 125 128 127 128 127 125 125 125 125 125 125 125 125 
125 125 125 125 125 125 125 125 130 129 130 129 125 125 125 125 125 125 125 125 125 125 130 129 125 125 125 125 125 125 125 125 
125 125 131 132 131 132 131 132 127 128 127 128 125 125 125 125 125 125 125 125 131 132 127 128 125 125 125 125 125 125 125 125 
125 125 129 130 129 130 129 130 129 130 129 130 125 125 125 125 125 125 125 125 129 130 129 130 125 125 125 125 125 125 125 125 
125 125 128 127 128 127 128 127 128 127 128 127 125 125 125 125 125 125 125 125 128 127 128 127 125 125 125 125 125 125 125 125 
125 125 125 125 130 129 130 129 125 125 125 125 125 125 125 125 125 125 125 125 130 129 125 125 125 125 125 125 125 125 125 125 
125 125 131 132 127 128 127 128 131 132 131 132 131 132 131 132 131 132 131 132 127 128 131 132 125 125 125 125 125 125 125 125 
125 125 129 130 129 130 129 130 129 130 129 130 129 130 129 130 129 130 129 130 129 130 129 130 125 125 125 125 125 125 125 125 
125 125 128 127 128 127 128 127 128 127 128 127 128 127 128 127 128 127 128 127 128 127 128 127 125 125 125 125 125 125 125 125 
125 125 125 125 125 125 125 125 125 125 125 125 130 129 130 129 130 129 130 129 125 125 125 125 125 125 125 125 125 125 125 125 
125 125 125 125 125 125 125 125 131 132 131 132 127 128 127 128 127 128 127 128 131 132 131 132 125 125 125 125 125 125 125 125 
125 125 125 125 125 125 125 125 129 130 129 130 129 130 129 130 129 130 129 130 129 130 129 130 125 125 125 125 125 125 125 125 
125 125 125 125 125 125 125 125 128 127 128 127 128 127 128 127 128 127 128 127 128 127 128 127 125 125 125 125 125 125 125 125 
125 125 125 125 125 125 125 125 130 129 130 129 125 125 125 125 125 125 125 125 130 129 130 129 125 125 125 125 125 125 125 125 

3 
TOMB 144 208
ENEMY LCLOUD 256 16
ENEMY LCLOUD 400 16
