32 20
125 125 127 128 127 128 127 128 127 128 127 128 127 128 127 128 127 128 127 128 127 128 127 128 127 128 127 128 127 128 125 125 
125 125 129 130 129 130 129 130 129 130 129 130 129 130 129 130 129 130 129 130 129 130 129 130 129 130 129 130 129 130 125 125 
125 125 128 127 128 127 128 127 128 127 128 127 128 127 128 127 128 127 128 127 128 127 128 127 128 127 128 127 128 127 125 125 
125 125 125 125 125 125 125 125 130 129 130 129 126 126 125 125 125 125 125 125 125 125 125 125 130 129 130 129 125 125 125 125 
125 125 131 132 131 132 131 132 127 128 127 128 131 132 131 132 131 132 131 132 131 132 131 132 127 128 127 128 131 132 125 125 
125 125 129 130 129 130 129 130 129 130 129 130 129 130 129 130 129 130 129 130 129 130 129 130 129 130 129 130 129 130 125 125 
125 125 128 127 128 127 128 127 128 127 128 127 128 127 128 127 128 127 128 127 128 127 128 127 128 127 128 127 128 127 125 125 
125 125 130 129 130 129 125 125 125 125 125 125 125 125 125 125 130 129 130 129 125 125 126 126 125 125 125 125 130 129 125 125 
125 125 127 128 127 128 131 132 131 135 136 132 131 132 131 132 127 128 127 128 131 132 131 132 131 132 131 132 127 128 125 125 
125 125 129 130 129 130 129 130 129 137 138 130 129 130 129 130 129 130 129 130 129 130 129 130 129 130 129 130 129 130 125 125 
125 125 128 127 128 127 128 127 128 139 140 127 128 127 128 127 128 127 128 127 128 127 128 127 128 127 128 127 128 127 125 125 
125 125 130 129 130 129 130 129 125 125 126 126 125 125 125 125 125 125 125 125 130 129 125 125 125 125 125 125 125 125 125 125 
125 125 127 128 127 128 127 128 131 132 131 132 131 132 131 132 131 132 131 132 127 128 131 132 131 132 131 132 131 132 125 125 
125 125 129 130 129 130 129 130 129 130 129 130 129 130 129 130 129 130 129 130 129 130 129 130 129 130 129 130 129 130 125 125 
125 125 128 127 128 127 128 127 128 127 128 127 128 127 128 127 128 127 128 127 128 127 128 127 128 127 128 127 128 127 125 125 
125 125 125 125 125 125 125 125 125 125 125 125 130 129 130 129 125 125 125 125 125 125 125 125 125 125 125 125 126 126 125 125 
125 125 131 132 131 135 136 132 131 132 131 132 127 128 127 128 131 132 131 132 131 135 136 132 125 125 131 132 131 132 131 132 
125 125 129 130 129 137 138 130 129 130 129 130 129 130 129 130 129 130 129 130 129 137 138 130 125 125 129 130 129 130 129 130 
125 125 128 127 128 139 140 127 128 127 128 127 128 127 128 127 128 127 128 127 128 139 140 127 125 125 128 127 128 127 128 127 
125 125 125 125 125 125 125 125 130 129 125 125 125 125 125 125 125 125 125 125 125 125 125 125 125 125 130 129 125 125 125 125 

12 
LADDER 320 0 3 0
LADDER 96 0 3 0
LADDER 192 64 3 0
LADDER 352 128 3 0
LADDER 160 192 3 0
LADDER 448 256 3 0
TOMB 336 80
WKEYDOOR 272 192 1
WKEYDOOR 272 256 1
ENEMY LCLOUD 192 16
ENEMY LCLOUD 224 48
ENEMY LCLOUD 384 16
