32 20
127 128 127 128 127 128 127 128 127 128 127 128 127 128 127 128 127 128 127 128 127 128 127 128 127 128 127 128 127 128 125 125 
129 130 129 130 129 130 129 130 129 130 129 130 129 130 129 130 129 130 129 130 129 130 129 130 129 130 129 130 129 130 125 125 
128 127 128 127 128 127 128 127 128 127 128 127 128 127 128 127 128 127 128 127 128 127 128 127 128 127 128 127 128 127 125 125 
125 125 125 125 125 125 125 125 125 125 125 125 125 125 125 125 125 125 125 125 125 125 125 125 125 125 125 125 125 125 125 125 
125 125 131 132 131 132 131 132 131 135 136 132 131 132 131 132 131 132 125 125 131 132 131 132 131 132 131 132 131 132 125 125 
125 125 129 130 129 130 129 130 129 137 138 130 129 130 129 130 129 130 125 125 129 130 129 130 129 130 129 130 129 130 125 125 
125 125 128 127 128 127 128 127 128 139 140 127 128 127 128 127 128 127 125 125 128 127 128 127 128 127 128 127 128 127 125 125 
125 125 125 125 125 125 125 125 125 125 125 125 126 126 125 125 125 125 125 125 125 125 126 126 130 129 130 129 125 125 125 125 
131 135 136 132 131 132 131 132 131 132 131 132 131 132 131 132 131 135 136 132 131 132 131 132 127 128 127 128 131 132 125 125 
129 137 138 130 129 130 129 130 129 130 129 130 129 130 129 130 129 137 138 130 129 130 129 130 129 130 129 130 129 130 125 125 
128 139 140 127 128 127 128 127 128 127 128 127 128 127 128 127 128 139 140 127 128 127 128 127 128 127 128 127 128 127 125 125 
125 125 125 125 125 125 125 125 130 129 130 129 125 125 125 125 125 125 125 125 130 129 130 129 130 129 125 125 125 125 125 125 
125 125 125 125 125 125 125 125 127 128 127 128 131 132 131 132 131 132 125 125 127 128 127 128 127 128 131 132 131 135 136 132 
125 125 125 125 125 125 125 125 129 130 129 130 129 130 129 130 129 130 125 125 129 130 129 130 129 130 129 130 129 137 138 130 
125 125 125 125 125 125 125 125 128 127 128 127 128 127 128 127 128 127 125 125 128 127 128 127 128 127 128 127 128 139 140 127 
125 125 125 125 125 125 125 125 130 129 125 125 125 125 130 129 130 129 125 125 125 125 125 125 130 129 125 125 125 125 125 125 
125 125 125 125 125 125 125 125 127 128 131 132 131 132 127 128 127 128 125 125 131 132 131 132 127 128 131 132 131 132 125 125 
125 125 125 125 125 125 125 125 129 130 129 130 129 130 129 130 129 130 125 125 129 130 129 130 129 130 129 130 129 130 125 125 
125 125 125 125 125 125 125 125 128 127 128 127 128 127 128 127 128 127 125 125 128 127 128 127 128 127 128 127 128 127 125 125 
125 125 125 125 125 125 125 125 125 125 125 125 125 125 125 125 125 125 125 125 125 125 125 125 125 125 125 125 125 125 125 125 

4 
TOMB 400 16
LADDER 352 128 7 0
LADDER 192 128 3 0
ENEMY GLIZARD 128 16
