32 20
127 128 127 128 127 128 127 128 127 128 127 128 127 128 127 128 127 128 127 128 127 128 127 128 127 128 127 128 127 128 127 128 
129 130 129 130 129 130 129 130 129 130 129 130 129 130 129 130 129 130 129 130 129 130 129 130 129 130 129 130 129 130 129 130 
128 127 128 127 128 127 128 127 128 127 128 127 128 127 128 127 128 127 128 127 128 127 128 127 128 127 128 127 128 127 128 127 
130 129 130 129 130 129 130 129 130 129 130 129 125 125 130 129 125 125 130 129 130 129 130 129 130 129 130 129 130 129 130 129 
127 128 127 128 127 128 127 128 127 128 127 128 131 132 127 128 131 132 127 128 127 128 127 128 127 128 127 128 127 128 127 128 
129 130 129 130 129 130 129 130 129 130 129 130 129 130 129 130 129 130 129 130 129 130 129 130 129 130 129 130 129 130 129 130 
128 127 128 127 128 127 128 127 128 127 128 127 128 127 128 127 128 127 128 127 128 127 128 127 128 127 128 127 128 127 128 127 
130 129 130 129 130 129 125 125 130 129 130 129 130 129 130 129 130 129 125 125 130 129 130 129 130 129 130 129 125 125 130 129 
127 128 127 128 127 128 131 132 127 128 127 128 127 128 127 128 127 128 131 132 127 128 127 128 127 128 127 128 131 132 127 128 
129 130 129 130 129 130 129 130 129 130 129 130 129 130 129 130 129 130 129 130 129 130 129 130 129 130 129 130 129 130 129 130 
128 127 128 127 128 127 128 127 128 127 128 127 128 127 128 127 128 127 128 127 128 127 128 127 128 127 128 127 128 127 128 127 
130 129 130 129 130 129 130 129 125 125 130 129 130 129 130 129 130 129 130 129 130 129 130 129 125 125 130 129 130 129 130 129 
127 128 127 128 127 128 127 128 131 132 127 128 127 128 127 128 127 128 127 128 127 128 127 128 131 132 127 128 127 128 127 128 
129 130 129 130 129 130 129 130 129 130 129 130 129 130 129 130 129 130 129 130 129 130 129 130 129 130 129 130 129 130 129 130 
128 127 128 127 128 127 128 127 128 127 128 127 128 127 128 127 128 127 128 127 128 127 128 127 128 127 128 127 128 127 128 127 
130 129 125 125 130 129 130 129 130 129 130 129 130 129 130 129 130 129 130 129 130 129 130 129 130 129 130 129 130 129 130 129 
163 163 163 163 163 163 163 163 163 163 163 163 163 163 163 163 163 163 163 163 163 163 163 163 163 163 163 163 163 163 163 163 
164 164 164 164 164 164 164 164 164 164 164 164 164 164 164 164 164 164 164 164 164 164 164 164 164 164 164 164 164 164 164 164 
164 164 164 164 164 164 164 164 164 164 164 164 164 164 164 164 164 164 164 164 164 164 164 164 164 164 164 164 164 164 164 164 
165 165 165 165 165 165 165 165 165 165 165 165 165 165 165 165 165 165 165 165 165 165 165 165 165 165 165 165 165 165 165 165 

5 
WITEM 256 16 2
ENEMY BAT 192 64
ENEMY BAT 256 64
ENEMY BAT 288 128
ENEMY BAT 384 192

LAVA
