32 20
125 125 127 128 127 128 127 128 127 128 127 128 127 128 127 128 127 128 127 128 127 128 127 128 127 128 127 128 127 128 125 125 
125 125 129 130 129 130 129 130 129 130 129 130 129 130 129 130 129 130 129 130 129 130 129 130 129 130 129 130 129 130 125 125 
125 125 128 127 128 127 128 127 128 127 128 127 128 127 128 127 128 127 128 127 128 127 128 127 128 127 128 127 128 127 125 125 
125 125 125 125 125 125 126 126 125 125 126 126 125 125 125 126 126 125 125 125 126 126 125 125 126 126 125 125 125 125 125 125 
125 125 131 132 131 132 131 132 131 132 131 132 131 132 131 132 131 132 131 132 131 132 131 132 131 132 131 132 131 132 125 125 
125 125 129 130 129 130 129 130 129 130 129 130 129 130 129 130 129 130 129 130 129 130 129 130 129 130 129 130 129 130 125 125 
125 125 128 127 128 127 128 127 128 127 128 127 128 127 128 127 128 127 128 127 128 127 128 127 128 127 128 127 128 127 125 125 
125 125 125 125 125 125 126 126 125 125 126 126 125 125 125 126 126 125 125 125 126 126 125 125 126 126 125 125 125 125 125 125 
125 125 131 132 131 132 131 132 131 132 131 132 131 132 131 132 131 132 131 132 131 132 131 132 131 132 131 132 131 132 125 125 
125 125 129 130 129 130 129 130 129 130 129 130 129 130 129 130 129 130 129 130 129 130 129 130 129 130 129 130 129 130 125 125 
125 125 128 127 128 127 128 127 128 127 128 127 128 127 128 127 128 127 128 127 128 127 128 127 128 127 128 127 128 127 125 125 
125 125 125 125 125 125 126 126 125 125 126 126 125 125 125 126 126 125 125 125 126 126 125 125 126 126 125 125 125 125 125 125 
125 125 131 132 131 132 131 132 131 132 131 132 131 132 131 132 131 132 131 132 131 132 131 132 131 132 131 132 131 132 125 125 
125 125 129 130 129 130 129 130 129 130 129 130 129 130 129 130 129 130 129 130 129 130 129 130 129 130 129 130 129 130 125 125 
125 125 128 127 128 127 128 127 128 127 128 127 128 127 128 127 128 127 128 127 128 127 128 127 128 127 128 127 128 127 125 125 
125 125 125 125 125 125 126 126 125 125 126 126 125 125 125 126 126 125 125 125 126 126 125 125 126 126 125 125 125 125 125 125 
131 132 131 132 131 132 131 132 131 132 131 132 131 132 131 132 131 132 131 132 131 132 131 132 131 132 131 132 131 132 125 125 
129 130 129 130 129 130 129 130 129 130 129 130 129 130 129 130 129 130 129 130 129 130 129 130 129 130 129 130 129 130 125 125 
128 127 128 127 128 127 128 127 128 127 128 127 128 127 128 127 128 127 128 127 128 127 128 127 128 127 128 127 128 127 125 125 
125 125 125 125 125 125 125 125 125 125 125 125 125 125 125 125 125 125 125 125 125 125 125 125 125 125 125 125 125 125 125 125 

30 
LADDER 96 256 3 0
LADDER 160 256 3 0
LADDER 240 256 3 0
LADDER 320 256 3 0
LADDER 384 256 3 0
LADDER 384 192 3 0
LADDER 320 192 3 0
LADDER 240 192 3 0
LADDER 160 192 3 0
LADDER 96 192 3 0
LADDER 96 128 3 0
LADDER 160 128 3 0
LADDER 240 128 3 0
LADDER 320 128 3 0
LADDER 384 128 3 0
LADDER 384 64 3 0
LADDER 320 64 3 0
LADDER 240 64 3 0
LADDER 160 64 3 0
LADDER 96 64 3 0
STONE 64 16 39
STONE 128 80 39
STONE 64 144 39
STONE 192 208 39
STONE 288 272 39
STONE 288 144 39
STONE 288 80 39
STONE 352 16 39
STONE 352 208 39
STONE 416 144 39

PAMPERSE