32 20
127 128 127 128 127 128 127 128 127 128 127 128 127 128 127 128 127 128 127 128 127 128 127 128 127 128 127 128 127 128 125 125 
129 130 129 130 129 130 129 130 129 130 129 130 129 130 129 130 129 130 129 130 129 130 129 130 129 130 129 130 129 130 125 125 
128 127 128 127 128 127 128 127 128 127 128 127 128 127 128 127 128 127 128 127 128 127 128 127 128 127 128 127 128 127 125 125 
130 129 130 129 130 129 125 125 130 129 130 129 130 129 130 129 130 129 130 129 130 129 130 129 130 129 130 129 130 129 125 125 
127 128 127 128 127 128 131 132 127 128 127 128 127 128 127 128 127 128 127 128 127 128 127 128 127 128 127 128 127 128 125 125 
129 130 129 130 129 130 129 130 129 130 129 130 129 130 129 130 129 130 129 130 129 130 129 130 129 130 129 130 129 130 125 125 
128 127 128 127 128 127 128 127 128 127 128 127 128 127 128 127 128 127 128 127 128 127 128 127 128 127 128 127 128 127 125 125 
130 129 125 125 130 129 130 129 130 129 130 129 125 125 130 129 130 129 125 125 130 129 130 129 125 125 125 125 125 125 125 125 
127 128 131 132 127 128 127 128 127 128 127 128 131 132 127 128 127 128 131 132 127 128 127 128 131 132 131 132 131 132 125 125 
129 130 129 130 129 130 129 130 129 130 129 130 129 130 129 130 129 130 129 130 129 130 129 130 129 130 129 130 129 130 125 125 
128 127 128 127 128 127 128 127 128 127 128 127 128 127 128 127 128 127 128 127 128 127 128 127 128 127 128 127 128 127 125 125 
130 129 130 129 130 129 130 129 130 129 130 129 130 129 130 129 130 129 130 129 130 129 125 125 125 125 125 125 125 125 125 125 
127 128 127 128 127 128 127 128 127 128 127 128 127 128 127 128 127 128 127 128 127 128 131 132 131 132 131 132 131 132 125 125 
129 130 129 130 129 130 129 130 129 130 129 130 129 130 129 130 129 130 129 130 129 130 129 130 129 130 129 130 129 130 125 125 
128 127 128 127 128 127 128 127 128 127 128 127 128 127 128 127 128 127 128 127 128 127 128 127 128 127 128 127 128 127 125 125 
130 129 130 129 130 129 130 129 130 129 130 129 130 129 130 129 130 129 130 129 125 125 125 125 130 129 130 129 130 129 125 125 
163 163 163 163 163 163 163 163 163 163 163 163 163 163 163 163 163 163 163 163 125 125 125 125 127 128 127 128 127 128 131 132 
164 164 164 164 164 164 164 164 164 164 164 164 164 164 164 164 164 164 164 164 125 125 125 125 129 130 129 130 129 130 129 130 
164 164 164 164 164 164 164 164 164 164 164 164 164 164 164 164 164 164 164 164 125 125 125 125 128 127 128 127 128 127 128 127 
165 165 165 165 165 165 165 165 165 165 165 165 165 165 165 165 165 165 165 165 125 125 125 125 125 125 125 125 125 125 125 125 

5 
TOMB 400 144
ENEMY BAT 384 128
ENEMY BAT 352 192
ENEMY BAT 288 128
ENEMY BAT 192 128
